 Well, I wanted to name him after his dad, Denton Winslow Crocker.	 ฉันอยากตั้งชื่อเขาตามพ่อของเขา เดนตัน วินสโลว์ คร็อกเกอร์
 So that was the name we chose.	 นั่นเป็นชื่อที่พวกเราเลือก
 He was a colicky little baby.	 เขาเป็นทารกตัวน้อยร้องไห้โยเย (ฌ็อง-มารี คร็อกเกอร์) (ซาราโทกาสปริงส์ นิวยอร์ก)
 And, uh, so we were up night and day with him.	 (ฌ็อง-มารี คร็อกเกอร์) (ซาราโทกาสปริงส์ นิวยอร์ก) เราก็เลยตื่นมาดูแลเขาทั้งวันทั้งคืน
 And my husband was a wonderful dad and very loving and attentive.	 สามีของฉันเป็นพ่อที่ยอดเยี่ยม เขารักและเอาใจใส่มาก
 He'd walk the floor with him.	 เขาอุ้มลูกเดินไปเดินมา
 And then he said one day, "He's a regular little mogul the way he rules our lives." So that's where the name came from.	 แล้ววันหนึ่งเขาก็พูดว่า "เขาเป็นผู้มีอำนาจตัวน้อยที่ธรรมดา เพราะเขามีอิทธิพลต่อชีวิตเรา นั่นจึงเป็นที่มาของชื่อ
 We called him Mogie.	 เราเรียกเขาว่าโมกี้
 Mogie Crocker was born June 3, 1947, the oldest of four children.	 โมกี้ คร็อกเกอร์เกิดวันที่ 3 มิถุนายน 1947 เป็นลูกคนโตในบรรดาพี่น้องสี่คน
 His father was a biology teacher, and Mogie was raised in college towns.	 พ่อของเขาเป็นครูสอนชีววิทยา และโมกี้ถูกเลี้ยงในเมืองของมหาวิทยาลัย
 Ithaca, Amherst, and finally Saratoga Springs, to which the family moved in 1960, when he was 13.	 อิทากา แอมเฮิร์ส และสุดท้ายที่ซาราโทกาสปริงส์ ที่ครอบครัวย้ายมาในปี 1960 ตอนที่เขาอายุ 13 ปี
 My mother read books to all of us.	 แม่ของฉันอ่านหนังสือให้เราทุกคนฟัง (แครอล คร็อกเกอร์) (ซาราโทกาสปริงส์ นิวยอร์ก)
 My brother was definitely the one who probably gravitated towards that more than I did.	 แน่นอนว่าพี่ชายของฉัน เป็นคนที่สนใจเรื่องนั้นมากกว่าฉัน
 He really feasted on books.	 เขาเพลิดเพลินกับหนังสือจริงๆ
 Mogie was an unusual boy.	 โมกี้เป็นเด็กที่ไม่ธรรมดา
 Intelligent, independent-minded, and too nearsighted to do well at team sports, he loved books about American history and American heroes.	 ฉลาด มีความคิดอิสระ และสายตาสั้นมาก เกินกว่าที่จะเล่นกีฬาเป็นทีมได้ดี เขาชอบหนังสือประวัติศาสตร์ และฮีโร่ของอเมริกา
 At 12, he started a diary in which he kept track of Cold War events.	 ตอนอายุ 12 ปี เขาเริ่มเขียนสมุดบันทึก ที่เขาติดตามเหตุการณ์สงครามเย็น
 "I hate Reds!" he wrote, and he admired most those who had proved willing to sacrifice themselves for a cause.	 เขาเขียนว่า "ผมเกลียดฝ่ายแดง" และเขาชื่นชมบุคคลที่พิสูจน์ว่ายินดี ที่จะเสียสละตัวเองเพื่อสงคราม
 President John F. Kennedy's call for every American to ask what he or she could do for their country had mirrored ideas he'd held since he was a small boy.	 ประธานาธิบดีจอห์น เอฟ เคนเนดี้ เรียกร้องต่อชาวอเมริกันทุกคน เพื่อถามถึงสิ่งที่เขาหรือเธอ อาจทำเพื่อประเทศของพวกเขาได้ เป็นการสะท้อนถึงความคิดที่เขามี ตั้งแต่เขายังเป็นเด็กชายตัวน้อย
 One evening when I was reading to Denton before he went to sleep, I chose a passage from Henry V, which is, "He today that sheds his blood with me shall be my brother.	 ค่ำวันหนึ่งตอนที่ฉันอ่านหนังสือ ให้เดนตันฟังก่อนเข้านอน ค่ำวันหนึ่งตอนที่ฉันอ่านหนังสือ ให้เดนตันฟังก่อนเข้านอน ฉันเลือกบทความจากเรื่องเฮนรีที่ห้า ซึ่งมีอยู่ว่า "เขาในวันนี้ที่ร่วมหลั่งเลือดกับข้า จักเป็นพี่น้องข้า
 And gentlemen in England now a-bed shall think themselves accurs'd they were not here and hold their manhood cheap while any speaks that fought with us upon St. Crispin's Day." I think that it was that sort of thing that made Denton want to be part of something important and brave.	 และเหล่าสุภาพบุรุษแห่งอังกฤษทั้งหลายเอ๋ย จงให้พวกเขาตรองด้วยตนเองเถิดว่า หากพวกเขาไม่ได้ปรากฏขึ้นที่นี่ จงให้พวกเขาตรองด้วยตนเองเถิดว่า หากพวกเขาไม่ได้ปรากฏขึ้นที่นี่ แลเกียรติแห่งบุรุษของพวกเขาก็ยิ่งลดต่ำลง เมื่อได้เอ่ยแต่ละถ้อยคำออกมา ว่าพวกเขาจะต่อยุทธกับเราในวันคริสเปียน" ฉันคิดว่าเรื่องราวพวกนั้น ทำให้เดนตันอยากเป็นส่วนหนึ่ง ของเรื่องที่สำคัญและกล้าหาญ
 I just stayed awake last night thinking about this thing.	 เมื่อคืนผมนอนไม่หลับเฝ้าคิดถึงแต่เรื่องนี้
 The more I think of it, I don't know what in the hell...	 (ลินดอน จอห์นสัน) (ประธานาธิบดีของสหรัฐอเมริกา) ยิ่งผมคิดถึงมัน ผมยิ่งไม่รู้ว่าทำไม...
 it looks like to me we're getting into another Korea.	 สำหรับผมมันดูเหมือน เราจะเข้าสู่สงครามเกาหลีอีก
 It just worries the hell out of me.	 มันทำให้ผมกังวลเป็นบ้าเลย
 I don't see what we can ever hope to get out of there with once we're committed.	 ผมไม่เห็นว่าเราจะหวังอะไรได้ เพื่อให้ออกมาจากที่นั่น เมื่อเราเข้าร่วมแล้ว
 I don't think it's worth fighting for and I don't think we can get out.	 ผมคิดว่ามันไม่คุ้มที่จะต่อสู้ และคิดว่าเราจะไม่สามารถออกมาได้
 And it's just the biggest damn mess I ever saw.	 และมันเป็นความยุ่งเหยิง ร้ายแรงที่สุดที่ผมเคยเห็นมาเลย
 It is, it's an awful mess.	 มันเป็นความยุ่งเหยิงที่ร้ายแรงจริงๆ
 I just thought about ordering those kids in there, and what in the hell am I ordering them out there for? One thing that has occurred to me-- What the hell is Vietnam worth to me? What is it worth to this country? Yeah, yeah.	 (แมคจอร์จ บันดี้) (ที่ปรึกษาฝ่ายความมั่นคงแห่งชาติ) ผมเคยคิดที่จะสั่งให้เด็กพวกนั้นไปที่นั่น แล้วทำไมผมถึงสั่งให้พวกเขาออกมาจากที่นั่นเสีย สิ่งหนึ่งที่เกิดขึ้นกับผม เวียดนามมีค่ากับผมยังไง มันมีค่ากับประเทศนี้ยังไง ใช่ครับ ใช่
 Now, of course, if you start running the communists, they may just chase you right into your own kitchen.	 ตอนนี้แน่นอนว่าถ้าคุณเริ่มวิ่งหนีพวกคอมมิวนิสต์ พวกเขาอาจจะวิ่งไล่ตามคุณ ไปถึงในครัวของคุณเองก็ได้
 Yeah. That's the trouble.	 ใช่ นั่นแหละปัญหา
 And that is what the rest of that half of the world is going to think if this thing comes apart on us.	 และนั่นเป็นสิ่งที่พวกที่เหลือของอีกครึ่งโลก จะคิดถ้าสิ่งนี้เกิดขึ้นกับเรา
 It's damned easy to get in a war, but it's going to be awfully hard to ever extricate yourself if you get in.	 การเข้าสู่สงครามเป็นเรื่องง่ายมาก แต่ถ้าเข้าร่วมไปแล้ว การเอาตัวเองออกมาจะเป็นเรื่องยากแสนเข็ญ
 It's very easy...	 มันง่ายมาก ผมอยากได้ยินวอลเตอร์ และแมคนามาราประเมินเรื่องนี้
 To debate it? All right, what's a possible time...	 - อภิปรายเรื่องนี้เหรอ ก็ได้ - ใช่ เป็นเวลาที่น่าจะเกิดขึ้นได้
 Tragedy had brought Lyndon Johnson to the presidency in November of 1963.	 โศกนาฏกรรมทำให้ลินดอน จอห์นสัน เป็นประธานาธิบดีในเดือนพฤศจิกายน ปี 1963
 And he would not feel himself fully in charge until he had faced the voters the following year.	 เขาคงไม่รู้สึกว่าตัวเองมีอำนาจเต็มที่ จนกระทั่งเขาได้พบผู้ลงคะแนนในปีถัดมา
 But his ambitions for his country were as great as those of his hero, Franklin Roosevelt.	 แต่ความทะเยอทะยานของเขา สำหรับประเทศนี้ยิ่งใหญ่มาก เท่ากับฮีโร่ของเขา แฟรงกลิน โรสเวลต์
 During his years in the White House, he would lead the struggle to win passage of more than 200 important pieces of legislation.	 ในช่วงสมัยของเขาในทำเนียบขาว เขานำการต่อสู้เพื่อชนะเส้นทาง ไปสู่กฎหมายที่สำคัญมากกว่า 200 รายการ
 The Civil Rights Act of 1964, the Voting Rights Act of 1965, federal aid to education, Head Start, Medicare, and a whole series of bills aimed at ending poverty in America, all intended to create what he called "The Great Society." In foreign affairs, Johnson was less self-assured.	 พระราชบัญญัติสิทธิพลเมืองปี 1964 พระราชบัญญัติการลงคะแนนเสียงปี 1965 การสนับสนุนการศึกษาของรัฐบาล โครงการการศึกษาแรกเริ่ม โครงการเมดิแคร์ และร่างกฎหมายทั้งหมด ที่มุ่งขจัดความยากจนในอเมริกา ทุกอย่างมุ่งที่จะสร้าง สิ่งที่เขาเรียกว่า สังคมที่ยิ่งใหญ่ ด้านการต่างประเทศ จอห์นสันไม่ค่อยมีความมั่นใจในตัวเองนัก
 "Foreigners are not like the folks I'm used to," he once said.	 "ชาวต่างประเทศไม่เหมือนผู้คนที่ผมคุ้นเคย" เขาเคยพูดเอาไว้
 To deal with them, he retained in office all of John Kennedy's top advisors.	 ในการรับมือกับพวกเขา เขาเก็บที่ปรึกษา อันดับสูงของจอห์น เคนเนดี้ไว้ทั้งหมด
 Dean Rusk at State, Robert McNamara at Defense, McGeorge Bundy as his National Security Advisor.	 ดีน รัสก์ กระทรวงต่างประเทศ โรเบิร์ต แมคนามาร่า กระทรวงกลาโหม แมคจอร์จ บันดี้ เป็นที่ปรึกษาด้านความมั่นคงแห่งชาติ
 "I need you," he told them, more than his predecessor had.	 เขาบอกพวกเขาว่า "ผมต้องการพวกคุณ" มากกว่าที่ผู้อยู่ในตำแหน่งก่อนหน้าเขา
 Publicly, Johnson pledged that "This nation will keep its commitments from South Vietnam to West Berlin." But privately, Vietnam filled him with dread.	 จอห์นสันพูดต่อหน้าสาธารณชนว่า "ประเทศนี้จะรักษาปณิธาน จากเวียดนามใต้ไปสู่เบอร์ลินตะวันตก" แต่โดยส่วนตัวแล้ว เวียดนามทำให้เขากลัว
 "It's going to be hell in a handbasket out there," his ambassador told him.	 "มันจะเข้าสู่สภาวะ ความสัมพันธ์ที่ย่ำแย่อย่างรวดเร็ว" เอกอัครราชทูตบอกเขา
 "I want the South Vietnamese to get off their butts and get out into those jungles and whip the hell out of some communists," the president said.	 "ผมอยากให้ชาวเวียดนามใต้ลุกขึ้นมา และเข้าไปในป่าพวกนั้น แล้วโค่นพวกคอมมิวนิสต์เสีย" ประธานาธิบดีกล่าว
 "And then I want 'em to leave me alone, because I've got some bigger things to do right here at home." Johnson had opposed the military coup that had overthrown and murdered South Vietnamese president Ngo Dinh Diem, fearing it would make a bad situation worse.	 "และจากนั้นผมอยากให้ พวกนั้นอย่ามายุ่งกับผม เพราะผมมีสิ่งอื่นที่ใหญ่กว่าต้องทำที่บ้าน" จอห์นสันคัดค้านการรัฐประหาร โดยกองทัพที่ล้มล้างอำนาจ และสังหารโง ดินห์ เดียม ประธานาธิบดีของเวียดนามใต้ เพราะกลัวว่าจะทำให้ สถานการณ์ที่เลวร้ายแย่ลงไปอีก
 It had.	 ซึ่งก็จริง
 The National Liberation Front, the Viet Cong, was making coordinated attacks throughout the countryside, some 400 of them in just two weeks.	 แนวร่วมปลดปล่อยแห่งชาติหรือเวียดกง ทำการโจมตีร่วมกันในชนบท ถึง 400 ครั้งในเพียงสองสัปดาห์
 When Diem was overthrown, we were so excited, we thought we were close to liberating the whole country.	 เมื่อเดียมถูกโค่นอำนาจ เรารู้สึกตื่นเต้นเป็นอย่างมาก เรานึกว่าเราใกล้จะปลดปล่อย ทั้งประเทศให้เป็นอิสระได้แล้ว (เล กวน กง) (เวียดกง)
 We began attacking the enemy day and night.	 เราเริ่มโจมตีศัตรูทั้งกลางวันและกลางคืน
 More and more puppet soldiers surrendered or defected to our side.	 พลทหารรายแล้วรายเล่ายอมแพ้ หรือไม่ก็เปลี่ยนฝ่ายเข้าข้างเรา
 More and more young people joined our armed forces.	 คนหนุ่มสาวเข้าร่วมกองทัพของเราเพิ่มขึ้นเรื่อยๆ
 An estimated 40% of the South Vietnamese countryside, and more than 50% of the people, were effectively in the hands of the Viet Cong.	 ประมาณ 40 เปอร์เซ็นต์ ของชาวเวียดนามใต้ในชนบท และมากกว่า 50 เปอร์เซ็นต์ของประชาชน อยู่ในมือของเวียดกงอย่างเต็มที่
 And the Vietnamese generals who had overthrown Ngo Dinh Diem were bickering among themselves.	 และเหล่านายพลของเวียดนาม ที่โค่นอำนาจโง ดินห์ เดียม ได้แตกคอกันเอง
 The assassination of Ngo Dinh Diem set in motion a series of coups.	 การสังหารโง ดินห์ เดียม (โรเบิร์ต โรลต์) (กองกำลังพิเศษ) เกิดขึ้นในการรัฐประหารหลายครั้ง
 Each government was less effective than the one before.	 รัฐบาลแต่ละชุดมีประสิทธิภาพ น้อยกว่ารัฐบาลชุดก่อน
 In January 1964, with U.S. encouragement, General Nguyen Khanh staged yet another coup.	 ในเดือนมกราคมปี 1964 ด้วยการสนับสนุนของสหรัฐอเมริกา (นายพลเหงียน คานห์) นายพลเหงียน คานห์ ยังได้วางแผนการรัฐประหารอีก
 In March, Johnson sent McNamara to Vietnam with instructions to show the people that Khanh was "our boy." Johnson said, "Let's get him out and get him speaking to people, and let McNamara go with him as well so that people can see that the United States is solidly behind this man." We fully support the people of South Vietnam.	 ในเดือนมีนาคม จอห์นสันส่งแมคนามาร่า ไปเวียดนามพร้อมคำสั่งว่า เพื่อแสดงให้ประชาชนเห็นว่า คานห์เป็นคนของเรา จอห์นสันบอกว่า "ให้เขาออกมา และพูดต่อหน้าประชาชน และให้แมคนามาร่าไปกับเขาด้วย เพื่อให้ประชาชนเห็นว่าสหรัฐอเมริกา (แซม วิลสัน) (กองทัพบก) อยู่เบื้องหลังผู้ชายคนนี้" เราสนับสนุนประชาชนของเวียดนามใต้เต็มที่
 It was natural for the American to support the man on the spot.	 เป็นธรรมดาที่ชาวอเมริกัน จะสนับสนุนคนที่อยู่ในตำแหน่ง
 So he went along with General Khanh in a kind of trip somewhere in the countryside.	 ดังนั้นเขาจึงไปพร้อมกับนายพลคานห์ (บุ๋ย เดียม) (ทูตของเวียดนามใต้) ในการเดินทางไปที่แห่งหนึ่งในชนบท
 When Khanh gave a tedious, long, laborious speech ending up with...	 ตอนที่คานห์กล่าวสุนทรพจน์ที่ยาวนาน น่าเบื่อ และใช้ความพยายามมากซึ่งจบด้วย...
 "Vietnam a thousand years." McNamara leaned over to the microphone and said...	 "เวียดนามหนึ่งพันปี" แมคนามาร่าไปที่ไมโครโฟนและพูดว่า
 The American pronounce it has a different meaning in Vietnamese.	 การออกเสียงของคนอเมริกัน มีความหมายอีกอย่างในภาษาเวียดนาม
 What he was saying was something like, "The little duck, he wants to lie down." He wasn't aware of the tonal difference.	 สิ่งที่เขาพูดมีความหมายเหมือนว่า "เป็ดน้อย เขาต้องการจะนอน" เขาไม่รู้เรื่องความแตกต่างของโทนเสียง
 And McNamara grabbed one fist and held them up.	 และแมคนามาร่าจับมือข้างหนึ่งและยกขึ้น
 And the crowd practically disintegrated on the cobblestones.	 และฝูงชนก็กระจายตัวบนพื้นก้อนหิน
 "No more of this coup shit," President Johnson told his advisors.	 "ไม่เอารัฐประหารแบบนี้แล้ว" ประธานาธิบดีบอกที่ปรึกษาของเขา
 But Khanh, too, lacked popular legitimacy, and other generals continued to jockey for power.	 แต่คานห์ก็ขาดความชอบที่นิยมเช่นกัน และนายพลคนอื่นก็ยังคงคุมอำนาจต่อ
 Washington turned a deaf ear to Buddhist calls for the genuinely representative government they'd hoped they'd get when Diem was overthrown.	 วอชิงตันเพิกเฉยต่อการเรียกร้องของชาวพุทธ สำหรับรัฐบาลผู้แทนแบบดั้งเดิม ที่พวกเขาหวังว่าจะได้รับ สำหรับรัฐบาลผู้แทนแบบดั้งเดิม ที่พวกเขาหวังว่าจะได้รับ เมื่อเดียมถูกโค่นอำนาจ
 Between January 1964 and June of 1965, there would be eight different governments.	 ระหว่างเดือนมกราคม ปี 1964 และมิถุนายน ปี 1965 น่าจะมีรัฐบาลที่แตกต่างกันแปดชุด
 All of their leaders were so close to the Americans that they were seen as puppets.	 ผู้นำทุกคนของรัฐบาลมีความใกล้ชิดกับชาวอเมริกัน และถูกมองว่าเป็นหุ่นเชิด
 One weary Johnson aide suggested that the national symbol of South Vietnam should be a turnstile.	 ผู้ช่วยที่เหนื่อยล้าของจอห์นสันแนะนำว่า สัญลักษณ์แห่งชาติของเวียดนามใต้ ควรเป็นประตูหมุน
 These demonstrating students seem to symbolize the kind of anarchy that is descending on Saigon these days.	 เหล่านักศึกษาที่มาประท้วง ดูเหมือนจะเป็นสัญลักษณ์ ถึงอนาธิปไตยที่โจมตีไซ่ง่อนทุกวันนี้
 This kind of political backbiting is having serious consequences in the countryside, for until a strong government begins to function here in Saigon, the war against the communists will continue to founder.	 การลอบกัดทางการเมืองแบบนี้ มีผลลัพธ์ที่เลวร้ายในชนบท จนกระทั่งรัฐบาลที่เข้มแข็ง เริ่มจะทำหน้าที่ในไซ่ง่อน สงครามต่อต้านคอมมิวนิสต์จะระส่ำระสายต่อไป
 It's very difficult to talk about Uncle Ho.	 การพูดถึงลุงโฮเป็นเรื่องยากมาก
 I was close to him.	 ผมใกล้ชิดกับเขา
 Once a senior cadre asked him, "Uncle, how come you wear rubber sandals and such simple khaki clothes?" And Ho asked him, "If your people are barefoot, what do you do? Who's above whom?" Ho Chi Minh was still a beloved figure in North Vietnam, still concerned that his country remained fragile, still wary that stepping up the conflict in the South might force the Americans to take a still more active role.	 ครั้งหนึ่งแกนนำอาวุโสถามเขาว่า "ลุง ทำไมถึงใส่รองเท้าแตะยางล่ะครับ แล้วก็ชุดกากีธรรมดานั่นอีก" และโฮถามเขาว่า "ถ้าประชาชนของคุณเดินเท้าเปล่า คุณจะทำยังไงล่ะ (ดง ซี เหงียน) (กองทัพเวียดนามเหนือ) ใครเหนือกว่าใคร" โฮจิมินห์ยังคงเป็นบุคคล ที่เคารพรักในเวียดนามเหนือ ซึ่งยังคงกังวลว่า ประเทศของเขายังคงบอบบาง ยังคงกังวลว่าการก้าวไปสู่ความขัดแย้งทางใต้ อาจบังคับให้พวกอเมริกัน มีบทบาทในเชิงรุกมากขึ้น
 But Ho now shared power with younger, more impatient leaders.	 แต่โฮได้ใช้อำนาจร่วมกับ ผู้นำที่มีความอดทนมากกว่าและอายุน้อยกว่า
 There had been change and turmoil in North Vietnam, too, just as there had been in Saigon and Washington, though Americans knew almost nothing about it.	 มีการเปลี่ยนแปลง และความโกลาหลในเวียดนามเหนือเช่นกัน เช่นเดียวกับที่เกิดในไซ่ง่อนและวอชิงตัน แต่ชาวอเมริกันแทบจะไม่รู้อะไรเลย
 There were two factions in the North.	 ในฝั่งเหนือมีการแบ่งเป็นสองฝ่าย
 Although they agreed on liberating the South, they were still debating how much violence should be used.	 แม้พวกเขาจะเห็นด้วยกับการปลดปล่อยฝ่ายใต้ (ฮุย ดึ๊ก) (เวียดนามเหนือ) พวกเขายังคงโต้เถียง ว่าควรใช้ความรุนแรงมากเพียงใด
 At the Ninth Party Plenum that began in Hanoi on November 22, 1963, the day President Kennedy was killed in Dallas, the Politburo had argued over how best to proceed in the war.	 ในการประชุมพรรคการเมืองครั้งที่เก้า ที่เริ่มในกรุงฮานอย (คณะกรรมการพรรคคอมมิวนิสต์) (ฮานอย) ในวันที่ 22 พฤศจิกายน ปี 1963 วันที่ประธานาธิบดีเคนเนดี้ถูกสังหารในดัลลัส คณะกรรมการพรรคคอมมิวนิสต์ โต้เถียงเรื่องจะทำให้ดีที่สุดอย่างไรในสงคราม
 North Vietnam's two communist patrons, the Soviet Union and China, were giving them conflicting advice.	 สองผู้อุปถัมภ์คอมมิวนิสต์ของเวียดนามเหนือ สหภาพโซเวียตและจีน สองผู้อุปถัมภ์คอมมิวนิสต์ของเวียดนามเหนือ สหภาพโซเวียตและจีน กำลังให้คำแนะนำที่ขัดแย้งกัน
 We called them the two big brothers.	 เราเรียกพวกเขาว่าสองพี่ใหญ่
 The USSR had a new policy of de-escalating the Cold War, while China urged worldwide revolution through violence.	 สหภาพโซเวียดมีนโยบายใหม่ ในการลดสงครามเย็น ในขณะที่จีนเร่งให้มีการปฏิรูปทั่วโลก... (เหงียน หง็อก) (กองทัพเวียดนามเหนือ) ด้วยความรุนแรง
 In two weeks of sometimes bitter debate, Ho Chi Minh, who favored the Soviet strategy, was outmaneuvered by party First Secretary Le Duan, who sided with the Chinese.	 ในสองสัปดาห์ของการโต้แย้งที่ขัดกันในบางครั้ง โฮจิมินห์ซึ่งเห็นด้วยกับกลยุทธ์ของโซเวียต ถูกเอาชนะโดยใช้อุบายโดย เล สวน เลขานุการเอกของพรรค ซึ่งอยู่ฝ่ายจีน
 So when they cast their ballots, Ho excused himself and left the room.	 ดังนั้นเมื่อพวกเขาให้ลงคะแนนเสียง โฮก็ขอตัวและออกจากห้องไป
 After that, Ho Chi Minh's actual power was significantly diminished.	 หลังจากนั้น พลังที่แท้จริงของโฮจิมินห์ ก็หายไปอย่างเห็นได้ชัด
 From then on, the person with total power, and who controlled the war, was Le Duan.	 ตั้งแต่นั้นมา คนที่มีอำนาจทั้งหมด และคนที่ควบคุมสงคราม คือเล สวน
 Le Duan believed that with Diem gone, and the Saigon government in disarray, it was time to move quickly in 1964.	 เล สวนเชื่อว่าเมื่อเดียมไปแล้ว และรัฐบาลไซ่ง่อนอยู่ในภาวะสับสน มันถึงเวลาที่จะเคลื่อนที่อย่างรวดเร็วในปี 1964
 He proposed a two-phase plan for victory in South Vietnam.	 เขาเสนอแผนที่มีสองระยะ เพื่อชัยชนะในเวียดนามใต้
 The first phase would destroy A.R.V.N. forces through big, "decisive battles".	 ระยะแรกจะทำลายกองกำลัง ของกองทัพบกสาธารณรัฐเวียดนาม ด้วยการต่อสู้ครั้งใหญ่และเด็ดเดี่ยว
 The second, an attack on the cities, Le Duan believed, would then set off popular revolts within them.	 ครั้งที่สองคือการโจมตีเมืองต่างๆ ที่เล สวนเชื่อว่า จะเป็นการยุติการปฏิบัติที่นิยมในเมืองเหล่านั้น
 Party leaders and others suspected of having opposed the plan were denounced as "revisionists," demoted, dismissed, imprisoned.	 ผู้นำพรรคการเมืองและคนอื่นๆ ที่ถูกสงสัยว่าคัดค้านแผน ถูกประณามว่า "ผู้ยึดถือลัทธิใหม่" ถูกลดตำแหน่ง ไล่ออก จำคุก ถูกลดตำแหน่ง ไล่ออก จำคุก
 Hundreds were sent to "re-education camps." "Uncle Ho wavers," Le Duan said, "but I have only one goal, final victory." Secretary McNamara on line 0.	 หลายร้อยคนถูกส่งไปค่ายปรับความรู้ใหม่ "ลุงโฮโลเล" เล สวนกล่าว "แต่ผมมีแค่เป้าหมายเดียว ชัยชนะสุดท้าย" ท่านรัฐมนตรีแมคนามาร่าอยู่ในสายศูนย์
 Bob? Yes, Mr. President? I hate to bother you, but...	 - บ็อบเหรอ - ครับ ท่านประธานาธิบดี (ลินดอน จอห์นสัน) (ประธานาธิบดีของสหรัฐอเมริกา) - ขอโทษที่รบกวน แต่... - ไม่เป็นไรเลยครับ
 No trouble at all.	 (โรเบิร์ต แมคนามาร่า) (รัฐมนตรีกระทรวงกลาโหม)
 Tell me, have we got anybody that's got a military mind that can give us some military plans for winning that war? Let's get some more of something, my friend, because I'm going to have a heart attack if you don't get me something.	 บอกผมที เราได้คนที่มีจิตใจแบบทหาร บอกผมที เราได้คนที่มีจิตใจแบบทหาร ที่สามารถวางแผนทางทหารให้เรา เพื่อชนะสงครามนั่นใช่ไหม ที่สามารถวางแผนทางทหารให้เรา เพื่อชนะสงครามนั่นใช่ไหม ลองไปหาคนมาเพิ่มอีกสิ เพื่อน เพราะผมจะหัวใจวายแน่ถ้าคุณไม่หาคนมาให้
 We need somebody over there that can get us some better plans than we got, because what we got is what we've had since '54.	 เราต้องการใครสักคนที่นั่น ที่สามารถคิดแผนที่ดีกว่าที่เรามี เพราะสิ่งที่เรามี คือสิ่งที่เรามีมาตั้งแต่ปี 1954
 We're not getting it done.	 เราทำไม่สำเร็จสักที เรากำลังจะแพ้
 We're... We're losing.	 เราทำไม่สำเร็จสักที เรากำลังจะแพ้ มันเป็นเหตุผลหนึ่งที่ผมอยากกลับไป
 Well, it's one reason I want to go back.	 มันเป็นเหตุผลหนึ่งที่ผมอยากกลับไป
 Kick 'em in the tail a little bit will help here at this point.	 เตะหางพวกเขาสักนิด น่าจะช่วยเรื่องนี้ได้ในตอนนี้
 Yeah.	 ใช่
 What I want is somebody to lay up some plans to trap these guys and whup hell out of 'em.	 สิ่งที่ผมต้องการ คือให้ใครบางคนคิดวางแผน เพื่อวางกับดักคนพวกนี้และเฆี่ยนพวกเขา
 Kill some of 'em.	 ฆ่าพวกเขาเสียบ้าง
 That's what I want to do.	 ผมอยากทำแบบนั้น
 I'll try and bring something back that will meet that objective.	 ผมจะพยายามและเอาบางอย่างกลับมา ที่จะเป็นไปตามวัตถุประสงค์นั้น
 Okay, Bob.	 โอเค บ็อบ
 Thank you.	 ขอบคุณ
 When his counselors urged him to do so, Johnson increased the number of American military personnel from 16,000 to more than 23,000 by the end of the year.	 เมื่อที่ปรึกษาของเขาเร่งให้เขาทำเช่นนั้น จอห์นสันเพิ่มจำนวนทหารอเมริกัน จาก 16,000 เป็นมากกว่า 23,000 นาย ทหารอเมริกัน 23,000 คน ในสิ้นปีนั้น
 But he wanted his own team in Saigon.	 แต่เขาต้องการทีมของตัวเองในไซ่ง่อน
 He replaced Henry Cabot Lodge, making General Maxwell Taylor his ambassador, and selected 49-year-old General William Westmoreland, a decorated commander from WWII and Korea, to lead the American military effort.	 เขาแทนที่เฮนรี คาบ็อท ล็อดจ์ และตั้งนายพลแมกซ์เวล เทย์เลอร์ เป็นเอกอัครราชทูตของเขา และเลือกนายพลวิลเลียม เวสต์มอร์แลนด์ วัย 49 ปี ผู้บัญชาการที่ติดเหรียญกล้าหาญ จากสงครามโลกครั้งที่สองและสงครามเกาหลี ให้นำกองกำลังทหารของอเมริกา
 The president hoped to force Hanoi to abandon its support for the guerrilla struggle in the South by gradually escalating military pressure.	 ประธานาธิบดีหวังจะบังคับให้ฮานอยเลิกสนับสนุน การต่อสู้แบบกองโจรในตอนใต้ โดยค่อยๆ เพิ่มแรงกดดันทางการทหาร
 He authorized American pilots to bomb North Vietnamese troops and installations in the neighboring country of Laos.	 เขาอนุญาตให้นักบินของอเมริกา วางระเบิดกองทัพเวียดนามเหนือ และค่ายทหารในลาว ซึ่งเป็นประเทศเพื่อนบ้าน (ลาว - เวียดนามเหนือ อ่าวตังเกี๋ย)
 And he directed the military to oversee South Vietnamese shelling of North Vietnamese islands and raids on coastal bases.	 และเขานำกองทัพทหาร เพื่อตรวจสอบการระดมยิงของเวียดนามใต้ ในเกาะของเวียดนามเหนือ และการจู่โจมฐานทัพบนชายฝั่ง
 All of it was to be conducted in secret.	 ทุกอย่างจะต้องทำเป็นความลับ
 The American people were not to be told.	 ประชาชนชาวอเมริกันจะต้องไม่รู้
 It was an election year.	 ปีนั้นเป็นปีเลือกตั้ง
 Meanwhile, the Joint Chiefs of Staff felt strongly that the United States was fighting on the enemy's terms and urged far more drastic and dramatic action, air strikes against "critical targets" in North Vietnam itself and the deployment of U.S. forces in South Vietnam, boots on the ground.	 ในขณะที่คณะเสนาธิการร่วมรู้สึกอย่างรุนแรงว่า สหรัฐอเมริกากำลังสู้ตามเงื่อนไขของศัตรู และเร่งให้มีการดำเนินการ ที่หนักหน่วงและรุนแรงกว่านี้ การโจมตีทางอากาศที่เป้าหมายสำคัญ ในเวียดนามเหนือเอง และการเคลื่อนกำลังพล ของสหรัฐอเมริกาในเวียดนามใต้ ส่งพลทหารราบเข้าไป
 Johnson refused, fearing that such aggressive moves would pull China into the conflict just as it had entered the Korean War in 1950.	 จอห์นสันปฏิเสธ เพราะกลัวว่าการเคลื่อนไหวที่ก้าวร้าวเช่นนั้น จะดึงประเทศจีนเข้าสู่ความขัดแย้ง เหมือนที่เคยเข้าร่วมสงครามเกาหลีในปี 1950
 They say get in or get out.	 พวกเขาบอกให้เข้ามาหรือออกไป (ลินดอน จอห์นสัน) (ประธานาธิบดีของสหรัฐอเมริกา)
 Yeah.	 - ใช่ - และผมบอกพวกเขา
 And I told them, we haven't got any Congress that will go with us, and we haven't got any mothers that will go with us in the war, and I got to win an election and then you can make a decision.	 (แมคจอร์จ บันดี้) (ที่ปรึกษาฝ่ายความมั่นคงแห่งชาติ) เราไม่ได้พาสภาคองเกรสมากับเรา และเราไม่ได้พาแม่คนไหนมากับเราในสงคราม และผมต้องชนะการเลือกตั้ง และคุณก็สามารถตัดสินใจได้
 Polls showed him with a commanding lead over his likely Republican opponent, Senator Barry F. Goldwater of Arizona, a blunt, uncompromising critic of what he charged was the administration's weakness in the face of communist aggression.	 โพลแสดงให้เห็นว่า เขาเป็นฝ่ายนำคู่แข่งพรรครีพับลิกัน วุฒิสมาชิกแบร์รี เอฟ โกลด์วอเตอร์ แห่งแอริโซนา นักวิจารณ์ที่ตรงไปตรงมา ไม่ออมชอม ถึงสิ่งที่เขากล่าวหา เป็นจุดอ่อนของฝ่ายบริหาร ต่อความก้าวร้าวของคอมมิวนิสต์
 Why does he put off facing the question of what to do about Vietnam? Does he hope that he can wait until after the election to confront the American public with the...	 ทำไมเขาเลื่อนการเผชิญกับคำถาม ถึงสิ่งที่ต้องทำเกี่ยวกับเวียดนาม เขาหวังว่าจะสามารถรอจนหลังเลือกตั้งเหรอ เพื่อเผชิญหน้ากับประชาชนชาวอเมริกันด้วย...
 Here were these communists who were overrunning Southeast Asia and Johnson's doing nothing about it.	 ที่นี่มีพวกคอมมิวนิสต์ ที่บุกรุกเอเชียตะวันออกเฉียงใต้ และจอห์นสันไม่จัดการอะไรกับเรื่องนี้
 My opponent has not told you what he plans to do about the Cold War.	 คู่แข่งของผมไม่ได้บอกพวกคุณว่า เขาวางแผนจะทำอะไรเกี่ยวกับสงครามเย็น
 I rode around the back of a flatbed truck in Perkasie with a bunch of my classmates singing Barry Goldwater campaign songs because Lyndon Johnson was not tough enough on those communists.	 ผมนั่งท้ายกระบะรถในเพอร์กาซี (บิล แอร์ฮาร์ต) (เพอร์กาซี เพนซิลเวเนีย) พร้อมกับเพื่อนร่วมชั้นกลุ่มหนึ่ง ร้องเพลงหาเสียงของแบร์รี โกลด์วอเตอร์ เพราะลินดอน จอห์นสันไม่เข้มแข็งพอ กับพวกคอมมิวนิสต์
 Johnson felt he did not yet have the political capital to take further action in Vietnam, but he asked his aide, William Bundy, to draft a congressional resolution authorizing him to use force if needed, to be sent to Capitol Hill when the time was right.	 จอห์นสันรู้สึกว่าเขายังไม่มีทุนทางการเมือง ที่จะดำเนินการต่อไปในเวียดนาม แต่เขาขอให้วิลเลียม บันดี้ ผู้ช่วยของเขา ร่างมติประชุมของสภาคองเกรส แต่เขาขอให้วิลเลียม บันดี้ ผู้ช่วยของเขา ร่างมติประชุมของสภาคองเกรส เพื่ออนุญาตให้เขาใช้กำลังได้หากจำเป็น เพื่อส่งไปยังอาคารรัฐสภา เมื่อถึงเวลาที่เหมาะสม
 On July 30, 1964, South Vietnamese ships under the direction of the U.S. military shelled two North Vietnamese islands in the Gulf of Tonkin.	 (เวียดนามเหนือ) (อ่าวตังเกี๋ย) ในวันที่ 30 กรกฎาคม 1964 เรือเวียดนามใต้ ภายใต้คำสั่งของกองทัพสหรัฐอเมริกา ในวันที่ 30 กรกฎาคม 1964 เรือเวียดนามใต้ ภายใต้คำสั่งของกองทัพสหรัฐอเมริกา ระดมยิงเกาะสองแห่ง ของเวียดนามเหนือในอ่าวตังเกี๋ย
 The tiny North Vietnamese Navy was put on high alert.	 กองทัพเรือขนาดเล็ก ของเวียดนามเหนือเฝ้าระวังสูงสุด
 What followed was one of the most controversial and consequential events in American history.	 สิ่งที่ตามมาคือหนึ่งในเหตุการณ์ที่น่าโต้แย้งที่สุด และมีผลสืบเนื่องในประวัติศาสตร์ของอเมริกา
 On the afternoon of August 2, the destroyer U.S.S. Maddox was moving slowly through international waters in the gulf on an intelligence-gathering mission in support of further South Vietnamese action against the North.	 ในตอนบ่ายของวันที่ 2 สิงหาคม เรือพิฆาตยูเอสเอสแมดด็อกซ์ ในตอนบ่ายของวันที่ 2 สิงหาคม เรือพิฆาตยูเอสเอสแมดด็อกซ์ เคลื่อนที่อย่างช้าๆ ผ่านน่านน้ำสากลในอ่าว เคลื่อนที่อย่างช้าๆ ผ่านน่านน้ำสากลในอ่าว เพื่อทำภารกิจรวบรวมข่าวกรอง ในการสนับสนุนการดำเนินการ ของเวียดนามใต้ต่อฝ่ายเหนือ ในการสนับสนุนการดำเนินการ ของเวียดนามใต้ต่อฝ่ายเหนือ
 The commander of a North Vietnamese torpedo-boat squadron moved to attack the Maddox.	 ผู้บัญชาการกองเรือรบตอร์ปิโด ของเวียดนามเหนือ เคลื่อนที่ไปโจมตีแมดด็อกซ์
 The Americans opened fire and missed.	 ทหารอเมริกาเริ่มยิงแต่พลาด
 North Vietnamese torpedoes also missed.	 ตอร์ปิโดของเวียดนามเหนือก็พลาดเช่นกัน
 But carrier-based U.S. planes damaged two of the North Vietnamese boats and left a third dead in the water.	 แต่เครื่องบินบนเรือบรรทุกอากาศยานของสหรัฐ ทำให้เรือของเวียดนามเหนือสองลำเสียหาย และทำให้ลำที่สามจมในน่านน้ำ
 Ho Chi Minh was shocked to hear of his navy's attack and demanded to know who had ordered it.	 โฮจิมินห์ตกใจที่ได้ยินการโจมตีทางเรือของตน และต้องการรู้ว่าใครเป็นคนสั่ง
 The officer on duty was officially reprimanded for impulsiveness.	 เจ้าหน้าที่ที่ปฏิบัติการได้รับการตำหนิ อย่างเป็นทางการสำหรับความหุนหันพลันแล่น
 No one may ever know who gave the order to attack.	 ไม่มีใครรู้เลยว่าใครเป็นคนสั่งให้โจมตี
 To this day, even the Vietnamese cannot agree.	 จนทุกวันนี้ แม้ชาวเวียดนามจะไม่เห็นด้วย
 But some believe it was Le Duan.	 แต่บางคนเชื่อว่าเล สวนเป็นคนสั่ง
 The person behind the decision had to have been First Secretary Le Duan.	 คนที่อยู่เบื้องหลังการตัดสินใจ ต้องเป็นเเลขานุการเอก เล สวน
 In 1964, Le Duan wanted to elevate the war to a new level.	 ในปี 1964 เล สวน ต้องการยกระดับสงคราม (ฮุย ดึ๊ก) (เวียดนามเหนือ) ไปสู่ระดับใหม่อีกขั้น
 Why would a shrewd, calculating leader like Le Duan do that? The countryside was in our hands.	 ทำไมผู้นำที่หลักแหลมและคำนวณเก่ง... (เหงียน หง็อก) (กองทัพเวียดนามเหนือ) อย่างเล สวนถึงทำแบบนั้น ชนบทอยู่ในเงื้อมมือของเรา
 And if the Americans hadn't intervened directly with a large military force, by 1965, perhaps, the South Vietnamese regime would have collapsed.	 และถ้าทหารอเมริกาไม่ได้แทรกแซงโดยตรง ด้วยกองกำลังทหารขนาดใหญ่ ในปี 1965 บางที ระบอบการปกครองของเวียดนามใต้ คงจะล่มสลายไปแล้ว
 Back in Washington, the Joint Chiefs urged immediate retaliation against North Vietnam.	 ย้อนกลับไปในวอชิงตัน เสนาธิการร่วมเร่งให้มี การตอบโต้ทันทีต่อเวียดนามเหนือ
 The president refused.	 ประธานาธิบดีปฏิเสธ
 Instead, the White House issued a warning about the "grave consequences" that would follow what it called "any further unprovoked" attacks, even though Johnson knew the attack had been provoked by the South Vietnamese raids on North Vietnam's islands.	 โดยทำเนียบขาวมีคำเตือน เกี่ยวกับ "ผลตามมาที่ร้ายแรง" ซึ่งจะเกิดตามหลังสิ่งที่เรียกว่า เกี่ยวกับ "ผลตามมาที่ร้ายแรง" ซึ่งจะเกิดตามหลังสิ่งที่เรียกว่า การโจมตี "ที่ไร้การปลุกปั่นใดๆ" แม้จอห์นสันจะรู้ว่าการโจมตีถูกปลุกปั่น โดยการจู่โจมของเวียดนามใต้ บนเกาะของเวียดนามเหนือ
 Both sides were playing a dangerous game.	 ทั้งสองฝ่ายกำลังเล่นเกมที่อันตราย
 On August 4, American radio operators mistranslated North Vietnamese radio traffic and concluded a new military operation was imminent.	 (วันที่ 4 สิงหาคม 1964) ในวันที่ 4 สิงหาคม ผู้ปฏิบัติการทางวิทยุของอเมริกา แปลสัญญาณวิทยุของเวียดนามเหนือผิด แปลสัญญาณวิทยุของเวียดนามเหนือผิด และสรุปว่ามีปฏิบัติการ ทางทหารครั้งใหม่ใกล้จะเกิดขึ้น
 Actually, Hanoi had simply called upon torpedo boat commanders to be ready for a new raid by the South Vietnamese.	 อันที่จริงแล้ว ฮานอยเพียงเรียก ผู้บัญชาการเรือตอร์ปิโด อันที่จริงแล้ว ฮานอยเพียงเรียก ผู้บัญชาการเรือตอร์ปิโด ให้เตรียมพร้อมสำหรับการจู่โจมครั้งใหม่ โดยฝ่ายเกาหลีใต้ ให้เตรียมพร้อมสำหรับการจู่โจมครั้งใหม่ โดยฝ่ายเกาหลีใต้
 The Maddox and another destroyer, the Turner Joy, braced for a fresh attack.	 แมดด็อกซ์และเทิร์นเนอร์จอย เรือพิฆาตอีกลำ เตรียมพร้อมสำหรับการโจมตีครั้งใหม่
 So did the White House.	 ทำเนียบขาวก็เช่นเดียวกัน
 Go ahead, Mac.	 ลงมือเลยแมค (9:43 น. เวลาฝั่งตะวันออก)
 I-I personally would recommend to you, after a second attack on our ships, that we do retaliate against the coast of North Vietnam some way or other...	 ผมจะแนะนำคุณเป็นการส่วนตัวนะ (โรเบิร์ต แมคนามาร่า) (รัฐมนตรีกระทรวงกลาโหม) หลังจากการโจมตีครั้งที่สองต่อเรือของเรา เราจะทำการตอบโต้ที่ชายฝั่งของเวียดนามเหนือ ด้วยทางใดทางหนึ่ง
 What I was thinking about when I was eating breakfast, when they move on us and they shoot at us, I think we not only ought to shoot at them, but almost simultaneously pull one of these things that you've been doing on one of their bridges or something.	 สิ่งที่ผมคิดถึงตอนที่กำลังกินอาหารเช้า... (ลินดอน จอห์นสัน) (ประธานาธิบดีของสหรัฐอเมริกา) เมื่อพวกเขามุ่งมาที่เราและยิงใส่เรา ผมคิดว่าเราไม่ควรเพียงแต่ยิงใส่พวกเขา แต่ควรจะดึงหนึ่งในสิ่งเหล่านี้ออกมาทันที แบบที่คุณทำกับสะพานแห่งหนึ่งของพวกเขา
 Exactly. I quite agree with you, Mr. President.	 ใช่เลย ผมเห็นด้วยเลยครับ ท่านประธานาธิบดี
 But I wish we could have something that we've already picked out, and just hit about three of them damn quick, right after.	 แต่ผมหวังว่าเราจะมีบางอย่าง ที่เราเลือกไว้อยู่แล้ว และโจมตีอีกสามแห่ง ที่เหลือให้เร็วหลังจากนั้นทันที
 No second attack ever happened, but at the time, anxious American sonar operators aboard the Maddox and Turner Joy convinced themselves one had.	 ไม่มีการโจมตีครั้งที่สองเกิดขึ้น แต่ในตอนนั้น ผู้ปฏิบัติการ ด้านโซนาร์ของอเมริกาที่วิตกกังวล ทำให้แมดด็อกซ์และเทิร์นเนอร์จอย เชื่อว่ามีการโจมตีเกิดขึ้น
 The attack was probable but not certain, Johnson was told, and since it had probably occurred, the president decided it should not go unanswered.	 จอห์นสันได้รับแจ้งว่า การโจมตีอาจเกิดขึ้นแต่ไม่แน่นอน และเนื่องจากมันอาจเกิดขึ้นได้ ประธานาธิบดีตัดสินใจว่า เรื่องนั้นควรได้รับการตอบกลับ
 Aggression by terror against the peaceful villagers of South Vietnam has now been joined by open aggression on the high seas against the United States of America.	 ความรุนแรงโดยความหวาดกลัว ต่อชาวบ้านที่รักสงบในเวียดนามใต้ ความรุนแรงโดยความหวาดกลัว ต่อชาวบ้านที่รักสงบในเวียดนามใต้ ได้รับการเข้าร่วมโดยความรุนแรง ที่เริ่มขึ้นในเขตทะเลหลวง ได้รับการเข้าร่วมโดยความรุนแรง ที่เริ่มขึ้นในเขตทะเลหลวง ต่อสหรัฐอเมริกา
 Yet our response, for the present, will be limited and fitting.	 แต่การตอบโต้ของเราในขณะนี้ จะถูกจำกัดและมีความเหมาะสม
 We Americans know, although others appear to forget, the risk of spreading conflict.	 พวกเราชาวอเมริกันรู้ดี แม้คนอื่นดูเหมือนจะลืม ความเสี่ยงของการขยายความขัดแย้ง
 We still seek no wider war.	 เรายังคงต้องการไม่ให้สงครามขยายวงออกไป
 If that came to be where we would be called upon to carry out our responsibilities, and having been well-trained for this, I never really gave it much thought.	 ถ้าเรื่องนั้นเกิดขึ้นในที่ที่เราจะถูกเรียกร้อง ให้ทำตามความรับผิดชอบของเรา และการได้รับการฝึกฝนอย่างดีสำหรับเรื่องนี้ (เอเวอเรตต์ อัลวาเรซ) (นักบินของกองทัพเรือ) ผมไม่เคยคิดถึงมันอย่างจริงจัง
 It was part of my duty.	 มันเป็นส่วนหนึ่งของหน้าที่ผม
 Lieutenant Everett Alvarez from Salinas, California, was aboard the U.S.S. carrier Constellation.	 เรือโทเอเวอเรตต์ อัลวาเรซ จากซาลินาส แคลิฟอร์เนีย ขึ้นเรือบรรทุกอากาศยานยูเอสเอส
 His squadron of Skyhawk A-4 planes was ordered to attack torpedo boat installations and oil facilities near the port of Hon Gai.	 ฝูงเครื่องบินสกายฮอว์คเอโฟร์ของเขา ถูกสั่งให้โจมตีที่ตั้งของเรือตอร์ปิโด และโรงน้ำมันใกล้ท่าเรือฮอนไก
 For the first time, American pilots were going to drop bombs on North Vietnam.	 เป็นครั้งแรกที่นักบินชาวอเมริกัน จะไปทิ้งระเบิดใส่เวียดนามเหนือ
 When we approached the target coming down from altitude, it was obvious that they could pick us up on their radar.	 เมื่อเราไปถึงเป้าหมายลงจากความสูง เห็นได้ชัดว่าเราพวกเขาอาจพบเราได้บนเรดาร์
 I remember my knees shaking.	 ผมจำได้ว่าเข่าของผมสั่น
 And I was saying, "Holy smokes, I'm going into war.	 และผมพูดว่า "ให้ตายสิ ฉันกำลังเข้าสู่สงคราม
 This is war." I was a bit scared.	 นี่คือสงคราม" ผมรู้สึกกลัวนิดหน่อย
 Once we went in and they started firing at us, the fear went away.	 เมื่อเราเข้าไปและพวกเขาเริ่มยิงใส่เรา ความกลัวก็หายไป
 Everything became smooth, deathly quiet in the cockpit.	 ทุกอย่างราบรื่น เงียบสนิทในห้องขับเครื่องบิน
 It was sort of like a symphony in the sense that my plane was just like a ballet in the sky, and I was just performing what I was doing.	 มันเป็นเหมือนเพลงซิมโฟนี ในแง่ที่ว่าเครื่องบินของผม เป็นเหมือนเต้นบัลเลต์ในท้องฟ้า และผมกำลังแสดงสิ่งที่ผมกำลังทำ
 And then I got hit.	 แล้วผมก็โดนยิง
 Mayday, Mayday.	 ขอความช่วยเหลือๆ
 Coastal militiamen captured Alvarez and turned him over to the North Vietnamese military.	 นายทหารชายฝั่งจับตัวอัลวาเรซไป และส่งตัวเขาให้กับกองทัพเวียดนามเหนือ
 One fella was yelling at me in Vietnamese and saying something.	 มีชายคนหนึ่งตะโกนใส่ผม เป็นภาษาเวียดนามและพูดบางอย่าง
 I started talking to him in Spanish.	 ผมก็เริ่มคุยกับเขาเป็นภาษาสเปน
 Don't ask me why.	 อย่าถามผมว่าเพราะอะไร
 It seemed like a good idea at the time.	 ตอนนั้นมันดูเหมือนเป็นความคิดที่ดีน่ะ
 After when they discovered U.S.A. on my ID card and then they started speaking to me in English.	 หลังจากนั้นเมื่อพวกเขาพบคำว่า สหรัฐอเมริกาในบัตรประจำตัวของผม (กองกำลังติดอาวุธของสหรัฐอเมริกา กองทัพเรือสหรัฐฯ ปฏิบัติการ) แล้วพวกเขาก็เริ่มคุยกับผมเป็นภาษาอังกฤษ
 Alvarez assumed he would be treated as a prisoner of war.	 อัลวาเรซสันนิษฐานว่า เขาจะได้รับการปฏิบัติเป็นเชลยสงครม
 I was sticking to the code of conduct, which is giving them name, rank, service number, and date of birth.	 ผมยึดมั่นตามหลักปฏิบัติ ซึ่งคือการบอกชื่อ ยศ หมายเลขประจำการและวันเดือนปีเกิด
 But they quickly reminded me that there was no state of war, no declaration of war.	 แต่พวกเขาเตือนผมอย่างรวดเร็ว ว่าไม่มีภาวะสงคราม ไม่มีการประกาศสงคราม
 So I could not be considered a prisoner of war.	 ดังนั้นผมไม่ถือว่าเป็นเชลยสงคราม
 I recall thinking about it, and I says, "You know what? They're right." Everett Alvarez was the first American airman to be shot out of the sky over North Vietnam, and the first to be imprisoned there.	 ผมจำได้ว่าคิดเรื่องนั้นและพูดไปว่า "รู้อะไรไหม พวกเขาพูดถูก" เอเวอเรตต์ อัลวาเรซ เป็นนักบินชาวอเมริกันคนแรก ที่ถูกยิงร่วงจากท้องฟ้าในเวียดนามเหนือ และเป็นคนแรกที่ถูกจำคุกที่นั่น
 Now, the president sent up to Capitol Hill the resolution he had asked his aide William Bundy to draft two months earlier.	 ตอนนี้ประธานาธิบดีจึงส่ง มติการประชุมไปยังอาคารรัฐสภา ตอนนี้ประธานาธิบดีจึงส่ง มติการประชุมไปยังอาคารรัฐสภา เขาขอให้วิลเลียม บันดี้ ผู้ช่วยของเขา ร่างขึ้นมาเมื่อสองเดือนก่อน เขาขอให้วิลเลียม บันดี้ ผู้ช่วยของเขา ร่างขึ้นมาเมื่อสองเดือนก่อน
 Johnson is sort of prepositioned to move anyway, and it gives him really the incident that he needs to go to Congress and ask for a resolution that will allow him to deal with what he sees as aggression in Vietnam.	 จอห์นสันเตรียมการล่วงหน้าที่จะเคลื่อนไหว และทำให้เขามีเหตุการณ์ที่เขาจำเป็น ต้องไปหาสภาคองเกรสและขอมติการประชุม ที่จะอนุญาตให้เขาจัดการกับสิ่งที่เขาเห็น เป็นความรุนแรงในเวียดนาม
 And what he gets is the Gulf of Tonkin Resolution, which is, what he says, like "Grandma's nightshirt", it covers everything.	 และสิ่งที่เขาได้รับคือมติอ่าวตังเกี๋ย ซึ่งตามสิ่งที่เขาพูด จะเหมือนชุดนอนของคุณยาย คือมันครอบคลุมทุกอย่าง (เจมส์ วิลแบงค์ส) (ที่ปรึกษากองทัพ)
 I think what Johnson is looking for is the opportunity, the right time to send a message to North Vietnam that we're serious about supporting South Vietnam.	 ผมคิดว่าสิ่งที่จอห์นสันกำลังมองหาคือโอกาส และเวลาที่เหมาะสม ที่จะส่งข้อความไปยังเวียดนามเหนือว่า เราจริงจังกับการสนับสนุนเวียดนามใต้
 That message is sent, I think we misread the enemy because they're just as serious as we are.	 ข้อความนั้นถูกส่งไป ผมคิดว่าเราอ่านศัตรูผิดไป เพราะพวกเขาก็จริงจังเหมือนกับเรา
 On August 7, 1964, by a vote of 88-2, the Senate passed what came to be called the Tonkin Gulf Resolution.	 ในวันที่ 7 สิงหาคม 1964 โดยการโหวด 88-2 ในวันที่ 7 สิงหาคม 1964 โดยการโหวด 88-2 วุฒิสภาผ่านสิ่งที่เรียกว่ามติอ่าวตังเกี๋ย วุฒิสภาผ่านสิ่งที่เรียกว่ามติอ่าวตังเกี๋ย
 In the House, not a single congressman opposed it.	 ในสภา ไม่มีสมาชิกสภาสักคนที่จะคัดค้าน
 Senator Goldwater could no longer plausibly claim Johnson was failing to fight back against North Vietnam, while those voters concerned that the United States was in danger of becoming too deeply involved admired the president's measured response.	 วุฒิสมาชิกโกลด์วอเตอร์ไม่อาจอ้างได้ว่า จอห์นสันล้มเหลวในการโต้ตอบเวียดนามเหนือ ในขณะที่ผู้โหวตเหล่านี้ก็กังวลว่า สหรัฐอเมริกาจะอยู่ในอันตราย จากการมีส่วนเกี่ยวข้องมากเกินไป แต่ก็ชื่นชมการตอบสนอง ที่รอบคอบของประธานาธิบดี
 Support for Johnson's handling of the war jumped overnight from 42% to 72%.	 แรงสนับสนุนการรับมือ ของจอห์นสันต่อสงครามเพิ่มขึ้นในข้ามคืน จาก 42 เปอร์เซ็นต์เป็น 72 เปอร์เซ็นต์
 The American public believed their president.	 ประชาชนชาวอเมริกัน เชื่อประธานาธิบดีของพวกเขา (แอลบีเจเพื่อสหรัฐอเมริกา)
 Le Duan and his comrades in Hanoi did not.	 แต่เล สวนและพวกของเขาในฮานอยไม่เชื่อ
 They had little faith in the president's claim that he sought no wider war.	 พวกเขาแทบจะไม่เชื่อ ในคำกล่าวอ้างของประธานาธิบดี ที่เขาไม่ต้องการให้สงครามขยายวงกว้าง
 They resolved to step up their efforts to win the struggle in the South before the United States escalated its presence by sending in combat troops.	 พวกเขาแก้ไขเพื่อเพิ่มความพยายาม ในการชนะการต่อสู้ในฝ่ายใต้ ก่อนที่สหรัฐอเมริกาจะขยายการมีตัวตน ด้วยการส่งกองกำลังต่อสู้
 For the first time, Hanoi began sending North Vietnamese regulars into the South, down the network of paths they had hacked out of the Laotian jungle, the Ho Chi Minh Trail.	 เป็นครั้งแรก ฮานอยเริ่มส่งทหารเวียดนามเหนือไปฝ่ายใต้ ฮานอยเริ่มส่งทหารเวียดนามเหนือไปฝ่ายใต้ ตามเครือข่ายของเส้นทาง ที่พวกเขาแผ้วถางป่าของลาว ตามเครือข่ายของเส้นทาง ที่พวกเขาแผ้วถางป่าของลาว เส้นทางโฮจิมินห์
 This is Bien Hoa Air Base, the biggest in South Vietnam, hours after being hit by a communist mortar barrage.	 นี่คือฐานทัพอากาศเบียนฮหว่า ใหญ่ที่สุดในเวียดนามใต้ หลายชั่วโมงหลังจากถูกยิง โดยการโจมตีด้วยปืนครกของคอมมิวนิสต์
 On November 1, Viet Cong guerrillas shelled the American airbase at Bien Hoa near Saigon.	 ในวันที่ 1 พฤศจิกายน กองโจรเวียดกงระดมยิงฐานทัพอากาศ ของอเมริกาที่เบียนฮหว่าใกล้ไซ่ง่อน กองโจรเวียดกงระดมยิงฐานทัพอากาศ ของอเมริกาที่เบียนฮหว่าใกล้ไซ่ง่อน
 Five Americans died.	 ทหารอเมริกาเสียชีวิตห้านาย
 Thirty were wounded.	 บาดเจ็บสามสิบนาย
 Five B-57 bombers were destroyed on the ground and 15 more were damaged.	 เครื่องบินทิ้งระเบิดบี-57 ห้าลำถูกทำลายเป็นจุณ และเสียหายอีก 15 ลำ
 Mr. Ambassador, do you think this shows any new capability that they've got, the Viet Cong? Uh, I would simply say they've never done this before.	 ท่านเอกอัครราชทูต ท่านคิดว่าเรื่องนี้แสดงถึงความสามารถใหม่ ที่พวกเวียดกงมีไหม ท่านคิดว่าเรื่องนี้แสดงถึงความสามารถใหม่ ที่พวกเวียดกงมีไหม (แมกซ์เวล เทย์เลอร์) (เอกอัครราชทูตของสหรัฐฯ) ผมคงพูดแค่ว่าพวกเขาไม่เคยทำแบบนี้มาก่อน
 The Joint Chiefs advised the president to mount an immediate all-out air attack on 94 targets in the North and to send in regular Army and Marine units, not more advisors, to South Vietnam as well.	 เสนาธิการร่วมแนะนำให้ประธานาธิบดีเพิ่ม การโจมตีทางอากาศทันที ใส่เป้าหมาย 94 แห่งในฝ่ายเหนือ และส่งกองทัพทหารประจำการ และหน่วยนาวิกโยธิน ไม่ใช่ที่ปรึกษาเพิ่มขึ้น ไปยังเวียดนามใต้เช่นกัน
 He would not do it.	 เขาน่าจะไม่ทำแบบนั้น
 The election was just two days away.	 การเลือกตั้งจะมีขึ้นในอีกแค่สองวัน
 Lyndon Baines Johnson won the presidency in his own right, and he won it by a landslide.	 ลินดอน เบนส์ จอห์นสันชนะ การเลือกตั้งประธานาธิบดีด้วยสิทธิของเขาเอง และเขาได้รับชัยชนะอย่างท่วมท้น
 Within a month, the president would approve what was called a "graduated response," limited air attacks on the Ho Chi Minh Trail in Laos and "tit for tat" retaliatory raids on North Vietnamese targets.	 ภายในหนึ่งเดือน ประธานาธิบดีจะอนุมัติ สิ่งที่เรียกว่า "การตอบสนองที่มีการศึกษา" การโจมตีทางอากาศที่จำกัด ที่เส้นทางโฮจิมินห์ในลาว และการโจมตีตอบโต้ ต่อเป้าหมายในเวียดนามเหนือ
 But he refused to undertake sustained bombing of the North until the South Vietnamese got their own house in order.	 แต่เขาปฏิเสธที่จะดำเนินการ ทิ้งระเบิดสนับสนุนของฝ่ายเหนือ จนกว่าเวียดนามใต้จะมีสภาของตัวเองเรียบร้อย
 In private, Johnson doubted that airpower alone would ever work and believed that he would eventually have to send in ground troops, though he was not yet willing publicly to say so.	 ในทางส่วนตัว จอห์นสันสงสัยว่า กำลังทางอากาศอย่างเดียวจะได้ผลไหม และเชื่อว่าในที่สุดเขาจะต้องส่งทหารพื้นราบไป แม้เขายังไม่ตั้งใจจะพูดเช่นนั้นต่อสาธารณชน
 In the fall of '64, Denton was 17 and he was determined to go into the service.	 ในฤดูใบไม้ร่วงปี 1964 เดนตันอายุ 17 ปี และเขามุ่งมั่นที่จะไปรับใช้ชาติ
 Mogie Crocker had been restless since the summer.	 โมกี้ คร็อกเกอร์กระสับกระส่ายมาตั้งแต่ฤดูร้อน
 After the Gulf of Tonkin incident, he had confided to his sister that he wanted to join the Navy, but he knew his parents would not sign the consent form that would have allowed a 17-year-old to enlist.	 หลังจากเหตุการณ์ในอ่าวตังเกี๋ย เขาบอกความลับกับพี่สาวของเขาว่า เขาต้องการเข้าร่วมกับกองทัพเรือ เขาบอกความลับกับพี่สาวของเขาว่า เขาต้องการเข้าร่วมกับกองทัพเรือ แต่เขารู้ว่าพ่อแม่ของเขา จะไม่ยอมเซ็นแบบฟอร์มให้ความยินยอม ที่จะอนุญาตให้บุคคลอายุ 17 ปีสมัครเป็นทหาร (ดิ แอตแลนติก) (ชาวอังกฤษที่ยิ่งใหญ่ที่สุด)
 He was talking about wanting to go into the service and that his attempts to go underage had failed.	 เขาพูดว่าเขาต้องการไปรับใช้ชาติ (แครอล คร็อกเกอร์) (ซาราโทกาสปริงส์ นิวยอร์ก) และความพยายามของเขา ที่จะไปโดยมีอายุต่ำกว่าเกณฑ์ไม่สำเร็จ
 And that he wanted my parents to support him in that.	 และเขาต้องการให้ พ่อแม่ของฉันสนันสนุนเขาเรื่องนั้น
 His parents tried to persuade him that he could be more useful to his country with a college education than as just another private.	 พ่อแม่ของเขาพยายามโน้มน้าวเขาว่า เขาสามารถทำประโยชน์ให้กับประเทศได้มากกว่า ด้วยการศึกษาในมหาวิทยาลัย มากกว่าการไปเป็นพลทหารอีกคน
 Mogie was adamant.	 โมกี้มีความแน่วแน่
 Monday morning he left for school.	 เช้าวันจันทร์ที่เขาออกไปเรียน
 And I watched him leave.	 ฉันดูเขาออกไป
 But that night he didn't come in for supper and he hadn't called.	 แต่คืนนั้นเขาไม่ได้กลับมากินมื้อค่ำ (ฌ็อง-มารี คร็อกเกอร์) (ซาราโทกาสปริงส์ นิวยอร์ก) และเขาไม่ได้โทรบอก
 The day that my brother ran away has to be one of the most bizarre experiences in my life.	 วันที่น้องชายของฉันหนีไป ต้องเป็นหนึ่งในประสบการณ์ ที่แปลกประหลาดที่สุดในชีวิตฉัน ต้องเป็นหนึ่งในประสบการณ์ ที่แปลกประหลาดที่สุดในชีวิตฉัน
 I eventually happened to look in my piggy bank and he had taken the money I had and left a note for me.	 ในที่สุดฉันก็ไปดูในกระปุกออมสินของฉัน เขาเอาเงินที่ฉันมีอยู่และทิ้งโน้ตไว้ให้ฉัน
 He had promised he would pay me back.	 เขาสัญญาว่าเขาจะใช้คืนให้ฉัน
 He was gone about four months and said that he would not come home unless we agreed to sign for him.	 เขาไปประมาณสี่เดือน และบอกว่าเขาจะไม่กลับบ้าน นอกจากเราจะยอมตกลงเซ็นให้เขา
 And he wouldn't be 18 until June.	 และเขายังไม่ถึง 18 ปีจนกว่าจะเดือนมิถุนายน
 But we did agree and he did come home.	 แต่เรายอมตกลงและเขาก็กลับบ้าน
 My husband felt it was an honor-bound agreement.	 สามีของฉันรู้สึกว่ามันเป็นข้อตกลงที่มีเกียรติ
 I was hoping that I could change his mind.	 ฉันหวังว่าฉันจะสามารถเปลี่ยนใจเขาได้
 To my mind, the Marine Corps represented the very best.	 ในความคิดผม นาวิกโยธินยอดเยี่ยมที่สุด
 And it does.	 และก็เป็นเช่นนั้น
 They are the best.	 พวกเขายอดเยี่ยมที่สุด
 And I wanted to be part of the best.	 และผมอยากเป็นส่วนหนึ่งของที่สุด (ฟิลิป เบรดี้) (ที่ปรึกษาของนาวิกโยธิน)
 I was competitive. I was pugnacious.	 ผมชอบแข่งขันและชอบต่อสู้
 But I wanted to get in the Marine Corps and go to the first war I could find.	 แต่ผมอยากเข้าร่วมนาวิกโยธิน และอยากร่วมสงครามแรกที่ผมจะพบได้
 Lieutenant Philip Brady, from Port Washington, New York, arrived in Saigon just a few days after Lyndon Johnson's election, one of the new advisors sent to help shore up the South Vietnamese military.	 เรือโทฟิลิป เบรดี้ จากพอร์ตวอชิงตัน นิวยอร์ก มาถึงไซ่ง่อนเพียงไม่กี่วัน หลังการเลือกตั้งของลินดอน จอห์นสัน หนึ่งในที่ปรึกษาใหม่ถูกส่งมาเพื่อช่วยเสริม กองทัพของเวียดนามใต้
 We must ensure that women and children are not injured.	 เราต้องแน่ใจว่าเด็กและสตรีจะไม่ได้รับบาดเจ็บ
 General Westmoreland himself greeted the newcomers.	 นายพลเวสต์มอร์แลนด์ มาทักทายผู้มาใหม่ด้วยตนเอง
 He was an impressive-looking man with an impressive record.	 เขาเป็นผู้ชายที่ดูน่าประทับใจ พร้อมกับประวัติที่น่าประทับใจ
 Many of the men he'd led in Tunisia, Sicily, and Normandy during World War II called him Superman.	 ทหารหลายนายที่เขานำทัพในตูนิเซีย ซิซิลี และนอร์มังดีในช่วงสงครามโลกครั้งที่สอง ทหารหลายนายที่เขานำทัพในตูนิเซีย ซิซิลี และนอร์มังดีในช่วงสงครามโลกครั้งที่สอง เรียกเขาว่าซูเปอร์แมน
 He'd fought with distinction in Korea, commanded the 101st Airborne, served as superintendent of West Point.	 เขาต่อสู้อย่างยอดเยี่ยมในเกาหลี บัญชาการกองพลส่งทางอากาศที่ 101 ทำหน้าที่เป็นผู้อำนวยการ โรงเรียนนายร้อยเวสต์พอยต์
 TIME magazine called him "the sinewy personification of the American fighting man." But at the same time, win the hearts and the minds of the people.	 นิตยสารไทม์เรียกเขาว่า "แบบอย่างที่แข็งแกร่งของทหารอเมริกัน" แต่ในเวลาเดียวกัน ก็เอาชนะใจและความคิดของประชาชน
 General Westmoreland told us that we were down on the five-yard line and we just needed a few more to go get the touchdown.	 นายพลเวสต์มอร์บอกเราว่า เราอยู่ที่เส้นห้าหลาและเราต้องการอีกนิดเดียว ที่จะไปถึงเป้าหมาย
 Then I went out and then I got on the ground.	 ผมก็เลยออกไปและลงพื้นที่
 And then I found out, "Don't you realize? We're losing this war." Lieutenant Brady was assigned to assist Captain Frank Eller, senior advisor to the 4th Battalion of the Vietnamese Marine Corps, an elite unit whose members called themselves the "Killer Sharks." You were told that you were going over there to guide, educate, and elevate essentially these "little fellas" on how to fight a war, when in fact, they knew exactly how to fight the war.	 แล้วผมก็พบว่า "ไม่รู้กันเลยเหรอ เรากำลังพ่ายแพ้ในสงครามนี้" เรือโทเบรดี้ถูกมอบหมาย ให้ช่วยนาวาเอกแฟรงก์ เอลเลอร์ ที่ปรึกษาอาวุโสของกองพันที่สี่ ของนาวิกโยธินเวียดนาม ที่ปรึกษาอาวุโสของกองพันที่สี่ ของนาวิกโยธินเวียดนาม หน่วยชั้นสูงที่มีสมาชิก ที่เรียกตัวเองว่า "ฉลามพิฆาต" หน่วยชั้นสูงที่มีสมาชิก ที่เรียกตัวเองว่า "ฉลามพิฆาต" คุณได้รับแจ้งว่าจะต้องไปที่นั่นเพื่อแนะนำ ให้ความรู้และให้กำลังใจ โดยเฉพาะอย่างยิ่ง เหล่าทหารหนุ่มเกี่ยวกับวิธีต่อสู้ในสงคราม ที่จริงแล้ว เมื่อพวกเขารู้วิธีต่อสู้ในสงคราม
 You were just an appendage.	 คุณก็จะเป็นแค่ตัวประกอบ
 You were there simply to guide assets that they didn't have, American artillery, American air strikes.	 คุณไปที่นั่นเพียงเพื่อแนะนำสินทรัพย์ที่พวกเขาไม่มี ปืนใหญ่และการโจมตีทางอากาศของอเมริกา
 Brady did his best to get to know the South Vietnamese marines in his unit.	 เบรดี้พยายามอย่างที่สุดเพื่อทำความรู้จัก นาวิกโยธินของเวียดนามใต้ในหน่วยของเขา
 Phil Brady come in as an assistant of the senior advisor.	 ฟิล เบรดี้มาในฐานะผู้ช่วยของที่ปรึกษาอาวุโส
 I said that, "You are not my advisor. You are my helper." And also, "You are so tall and big.	 ผมพูดว่า "คุณไม่ใช่ที่ปรึกษา คุณเป็นผู้ช่วยของผม" และพูดว่า "คุณตัวสูงและใหญ่มาก
 Stay away from me.	 อยู่ห่างจากผมนะ
 Because if you get close to me some Viet Cong sniper will shoot, shoot at you and then they miss you and then hit me." Lieutenant Tran Ngoc Toan, the son of a trucker, had escaped life with a hostile stepmother by entering the South Vietnamese Military Academy at Dalat.	 เพราะถ้าคุณเข้าใกล้ผม พวกมือปืนลอบยิงเวียดกงจะยิง... (ตรัน หง็อก ตวน) (นาวิกโยธินของเวียดนามใต้) ยิงใส่คุณแล้วพวกเขาจะยิงพลาด และยิงมาโดนผม" เรือโทตรัน หง็อก ตวน ลูกชายของคนขับรถบรรทุก หนีชีวิตที่มีแม่เลี้ยงใจร้าย ด้วยการเข้าโรงเรียนทหาร ของเวียดนามใต้ที่ด่าหลัต
 He'd been fighting the Viet Cong for more than two years.	 เขาต่อสู้กับเวียดกงมามากกว่าสองปี
 Toan was one of the junior officers.	 ตวนเป็นหนึ่งในเจ้าหน้าที่ผู้น้อย
 I think he was a... I think he was a company commander.	 ผมคิดว่าเขาเป็นผู้บัญชาการกองร้อย
 I knew him, I liked him.	 ผมรู้จักและชอบเขา
 He was a Dalat graduate, which is like their West Point.	 เขาเป็นผู้จบการศึกษาจากด่าหลัต ซึ่งเหมือนกับโรงเรียนนายร้อยเวสต์พอยต์
 Very dedicated.	 อุทิศตนเป็นอย่างมาก
 Later we found out we understand each other more than that, because we are at the same generation.	 ภายหลังเราพบว่า เราเข้าใจซึ่งกันและกันมากกว่านั้น เพราะเราอยู่ในรุ่นอายุเดียวกัน
 Brady, Toan, and the 4th South Vietnamese Marine Battalion were stationed near the Bien Hoa Airbase in reserve, waiting to be called into action.	 เบรดี้ ตวน และกองพันที่สี่ ของนาวิกโยธินเวียดนามใต้ ประจำการใกล้กับ ฐานทัพอากาศเบียนฮหว่าเป็นกำลังเสริม รอที่จะถูกเรียกให้ปฏิบัติการ
 There were new rumors now, of larger enemy units moving through the countryside.	 ตอนนี้มีข่าวลือใหม่ เรื่องหน่วยขนาดใหญ่ของศัตรู กำลังเคลื่อนพลผ่านชนบท
 Le Duan's plan to win a quick and decisive victory was underway.	 แผนของเล สวนที่จะได้ชัยชนะ ที่เร็วและเด็ดเดียวกำลังดำเนินต่อไป
 My youngest brother's name was Nguyen Thanh Hoang.	 น้องชายคนเล็กสุดของผมชื่อเหงียน ตันห์ ฮวง
 He was a scout.	 เขาเป็นทหารพราน
 He was killed.	 เขาถูกฆ่า
 If you enter the cemetery, his grave is on your left.	 ถ้าคุณไปที่สุสาน หลุมศพของเขาจะอยู่ทางซ้ายของคุณ (เหงียน วัน ต๋ง) (เวียดกง)
 It's the sixth grave in the sixth row.	 เป็นหลุมศพอันที่หกในแถวที่หก
 We visit his grave one a year to remember him.	 เราไปเยี่ยมหลุมศพของเขา ปีละครั้งเพื่อระลึกถึงเขา
 I would like to say one more thing.	 ผมอยากจะพูดอีกเรื่องหนึ่ง
 My brother had a fiancee.	 น้องชายของผมมีคู่หมั้น
 He brought her home to meet our mother.	 เขาพาเธอมาที่บ้านเพื่อพบแม่ของพวกเรา
 My mother was very happy to have her as a daughter-in-law.	 แม่ของผมดีใจมากที่จะได้เธอมาเป็นลูกสะใภ้
 When my brother was killed, she refused to marry another man, and took her own life instead.	 เมื่อน้องชายของผมถูกฆ่า เธอปฏิเสธที่จะแต่งงานกับชายอื่น เธอปฏิเสธที่จะแต่งงานกับชายอื่น และจบชีวิตของตัวเองแทน
 Nguyen Van Tong was a political officer in the newly created Viet Cong 9th Division, one of perhaps 2000 Viet Cong and North Vietnamese troops who had for weeks been quietly filtering into Phuoc Tuy, a supposedly "pacified" province less than 40 miles southeast of Saigon.	 เหงียน วัน ต๋งเป็นเจ้าหน้าที่ทางการเมือง ในหน่วยที่เก้าของเวียดกงที่เพิ่งสร้างขึ้นมาใหม่ หนึ่งในกองพล 2,000 กอง ของเวียดนามเหนือและเวียดกง ซึ่งแทรกซึมเงียบๆ มาหลายสัปดาห์ในฟุกทุย ที่เป็นจังหวัดซึ่งเงียบสงบทางตะวันออกเฉียงใต้ ของไซ่ง่อนน้อยกว่า 40 ไมล์
 My view was, in a war, if you can't destroy the enemy's main forces, the enemy's backbone, you can't win.	 ในสงคราม มุมมองของผมคือ ถ้าคุณไม่สามารถทำลายกองกำลังหลักของศัตรู ที่เป็นกระดูกสันหลังของศัตรู คุณก็เอาชนะไม่ได้
 If we didn't destroy those forces, the war would last forever.	 ถ้าเราไม่ทำลายกองกำลังพวกนั้น สงครามก็จะยืดเยื้ออีกนาน
 The target for Toan and his comrades was the strategic hamlet of Binh Gia, home to some 6,000 Catholic anticommunist refugees.	 เป้าหมายสำหรับต๋งและพวกของเขา คือหมู่บ้านยุทธศาสตร์ของบินห์เจีย เป้าหมายสำหรับต๋งและพวกของเขา คือหมู่บ้านยุทธศาสตร์ของบินห์เจีย (บินห์เจีย) (จังหวัดฟุกทุย) ที่อยู่ของผู้ลี้ภัยต่อต้านคอมมิวนิสต์ ชาวคาทอลิกจำนวน 6,000 คน
 Their plan was to seize the hamlet and then annihilate the forces Saigon was sure to send to retake it.	 แผนของพวกเขาคือการยึดหมู่บ้านนั้น และทำลายกองกำลัง ที่ไซ่ง่อนมั่นใจว่าจะส่งไปยึดคืน
 To ensure success, tons of heavy weapons were smuggled onto the coast under cover of darkness, mortars, machine guns, recoilless rifles capable of blasting tanks.	 เพื่อรับประกันความสำเร็จ อาวุธหนักจำนวนมากถูกส่งไปที่ชายฝั่ง ซ่อนภายใต้ความมืด ปืนครก ปืนกล ปืนไรเฟิล ไร้แรงสะท้อนถอยหลังที่สามารถระเบิดรถถัง
 The communists had never attempted anything on this scale before.	 พวกคอมมิวนิสต์ไม่เคยพยายาม ทำสิ่งใดในระดับนี้มาก่อน
 Before dawn on December 28, Viet Cong advance units easily overwhelmed the village militia and occupied Binh Gia.	 ก่อนรุ่งเช้าในวันที่ 28 ธันวาคม หน่วยล่วงหน้าของเวียดกง ทำลายกลุ่มติดอาวุธในหมู่บ้านได้อย่างง่ายดาย และยึดครองบินห์เจีย
 When two crack South Vietnamese Ranger companies were helicoptered in the next day, they were ambushed and shot to pieces.	 เมื่อกองร้อยทหารจู่โจม ของเวียดนามใต้สองหน่วย ถูกส่งไปทางเฮลิคอปเตอร์ในวันถัดไป พวกเขาถูกซุ่มโจมตีและยิงเละเป็นชิ้นๆ
 On the morning of the 30th, Philip Brady, his friend Tran Ngoc Toan, and the 4th Marine Battalion were flown in to relieve and reinforce the Rangers.	 ในเช้าของวันที่ 30 ฟิลิป เบรดี้และตรัน หง็อก ตวนเพื่อนของเขา และกองพันนาวิกโยธินที่สี่บินมาเพื่อบรรเทา และสนับสนุนทหารจู่โจม
 The enemy withdrew east of the village.	 ศัตรูถอนตัวจากฝั่งตะวันออกของหมู่บ้าน
 Around 5 p.m. a helicopter hovered over our position, right above the regimental command post.	 ประมาณห้าโมงเย็น เฮลิคอปเตอร์ บินเหนือตำแหน่งของเรา เหนือที่มั่นบัญชาการทางกรมทหาร
 The regimental commander asked, "Can you shoot it down?" We said, "Yes, we can." And a minute later the helicopter was hit and burst into flames.	 ผู้บัญชาการกรมทหารถามว่า "คุณยิงมันให้ร่วงได้ไหม" เราบอกว่า "ได้ครับ เราทำได้" และหนึ่งนาทีต่อมา เฮลิคอปเตอร์ถูกยิงและระเบิดเป็นไฟ
 All of a sudden you could see the tracers come out of the plantation, hit the helicopter, it crashed.	 ในทันใดนั้นคุณก็เห็น กระสุนพุ่งออกมาจากทุ่งนา กระสุนพุ่งออกมาจากทุ่งนา ยิงเฮลิคอปเตอร์จนร่วงลง
 We were ordered to go down and retrieve the remains the following morning.	 เราถูกสั่งให้ไปเก็บชิ้นส่วนที่เหลือในเช้าวันต่อมา
 I came to the place where the helicopter crashed, and I saw four Americans, dead.	 ผมมาจุดที่เฮลิคอปเตอร์ตก และผมเห็นทหารอเมริกันสี่นายตาย
 At the time, I didn't realize how valuable the lives of the American advisors were.	 ในตอนนั้น ผมไม่ได้ตระหนักว่า ชีวิตของที่ปรึกษาชาวอเมริกันจะมีค่าเพียงใด
 The commanding officer from Saigon told the battalion you have to come in and get all four American servicemen body.	 เจ้าหน้าที่บัญชาการจากไซ่ง่อน... (ตรัน หง็อก ตวน) (นาวิกโยธินเวียดนามใต้) บอกกองพันว่า คุณต้องมาที่นี่และรับร่าง ของทหารอเมริกันทั้งสี่นายไป คุณต้องมาที่นี่และรับร่าง ของทหารอเมริกันทั้งสี่นายไป
 They sent an entire battalion to retrieve four American advisors.	 พวกเขาส่งทั้งกองพันมา เพื่อรับที่ปรึกษาชาวอเมริกันทั้งสี่คน
 The lead company got to the remains and then was pounced on and mauled badly.	 กองร้อยแนวหน้าไปถึงเศษซาก แล้วถูกจู่โจมและทำร้ายอย่างรุนแรง
 Twelve South Vietnamese Marines from Toan's unit were killed getting to the downed helicopter.	 นาวิกโยธินเวียดนามใต้ 12 นาย จากหน่วยของตวนถูกฆ่า ระหว่างไปที่เฮลิคอปเตอร์ที่ตก
 Their comrades wrapped them in ponchos and laid them out next to the dead Americans.	 สหายของพวกเขาห่อร่างด้วยผ้าคลุม และวางพวกเขาไว้ข้างๆ ทหารอเมริกันที่เสียชีวิต
 An American chopper dropped into the clearing.	 เฮลิคอปเตอร์ของอเมริกาบินลงในที่โล่ง
 The American crew jumped out under fire, picked up the four Americans, climbed back into their chopper, and took off again.	 ทหารอเมริกันกระโดดลงมาภายใต้กระสุน รับร่างทหารอเมริกันทั้งสี่นาย ปีนกลับขึ้นเฮลิคอปเตอร์และบินขึ้นอีกครั้ง
 And we told them, "Hey, try to get all my body out of here too." But they refuse to pick up our body.	 และเราบอกพวกเขาว่า "เฮ้ มารับทั้งร่างของฉันไปจากที่นี่ด้วย" แต่พวกเขาปฏิเสธที่จะรับร่างของพวกเรา
 For three hours, Toan and his men stayed with their own dead waiting for a helicopter to carry them off the battlefield.	 เป็นเวลาสามชั่วโมง ตวนและคนของเขาอยู่กับผู้เสียชีวิต รอให้เฮลิคอปเตอร์มารับพวกเขาไปจากสนามรบ
 Meanwhile, I am getting a little bit antsy because, first of all, we're losing light.	 ในระหว่างนั้น ผมเริ่มรู้สึกกังวลเล็กน้อย เพราะว่าอย่างแรกคือเราจะไม่มีแสงสว่าง
 Second of all, we are now outside of artillery range.	 อย่างที่สองคือตอนนี้เราอยู่นอกระยะปืนใหญ่
 We've got to get out of there.	 เราต้องออกไปจากที่นี่
 We have to move out of here because they coming.	 เราต้องย้ายออกจากที่นี่ เพราะพวกมันกำลังมา
 And we don't have time.	 และเราไม่มีเวลาแล้ว
 I went to the Major Nho, his name was, and I said, "Major, we have to get out of here now." And Nho said, "Don't you forget I am a major, and you are a lieutenant," turned on his heel and walked away.	 ผมไปหาพันตรีโนห์ ชื่อของเขาตอนนั้น และผมก็พูดว่า "พันตรี เราต้องออกไปจากที่นี่เดี๋ยวนี้" และโนห์พูดว่า "อย่าลืมนะว่าผมเป็นพันตรี และคุณเป็นร้อยโท" เขาหันหลังกลับและเดินจากไป
 Ten minutes later all hell broke loose.	 สิบนาทีต่อมาก็เกิดความอลหม่านขึ้น
 They start shelling.	 พวกเขาเริ่มระดมยิง
 They start shelling into our bodies.	 พวกเขาเริ่มระดมยิงใส่ร่างของพวกเรา
 That's the first time in the war of Vietnam they start shelling before they attack.	 นั่นเป็นครั้งแรกในสงครามเวียดนาม พวกเขาเริ่มระดมยิงก่อนที่จะโจมตี
 The shelling eventually died down.	 ในที่สุดการระดมยิงค่อยๆ ยุติลง
 But then bugles blew, and wave after wave of enemy troops advanced toward the badly outnumbered men.	 แต่แล้วก็มีแตรทหารดังขึ้น และกองทัพศัตรูคลื่นแล้วคลื่นเล่า มุ่งหน้ามาที่ทหารที่มีจำนวนมากกว่าเยอะ
 It was as if you turned a soundtrack of shooting...	 ราวกับว่าคุณเป็นเพลงประกอบเป็นเสียงปืน
 It just went...  Just like that. All of a sudden it came out of nowhere.	 เสียงแบบว่า... แบบนั้นเลย ในทันใดนั้นมันมาจากไหนไม่รู้
 We used what little air strikes we had left with helicopters, calling in the strikes on our position to slow it down.	 เราใช้การโจมตีทางอากาศนิดหน่อย และเราก็ออกมาด้วยเฮลิคอปเตอร์ เรียกให้มีการโจมตีในตำแหน่งของเรา เพื่อทำให้มันช้าลง
 There was no way.	 ไม่มีทางอื่นแล้ว
 We were surrounded and they keep coming.	 เราถูกล้อมและพวกมันก็มาเรื่อยๆ
 I was shot.	 ผมถูกยิง
 The first shot, right here.	 นัดแรกตรงนี้
 And then, the second shot was right here.	 จากนั้น นัดที่สองเข้าตรงนี้
 The AK-47 put through right here, make a big hole like this.	 ปืนเอเค-47 ยิงเข้าตรงนี้ ทำให้เกิดรูใหญ่แบบนี้
 But I still keep fighting.	 แต่ผมยังสู้ต่อไป
 I don't feel any pain at all.	 ผมไม่รู้สึกเจ็บสักนิด
 I don't have time to think about it.	 ผมไม่มีเวลาคิดถึงมัน
 What we did was we tried to get out.	 สิ่งที่เราทำคือเราพยายามจะออกมา
 Twenty-six of us broke through.	 พวกเรา 26 นายฝ่าไป
 Eleven ultimately made it.	 ท้ายที่สุดมี 11 นายที่รอดชีวิตมาได้
 All that night, the Viet Cong moved among the trees, carrying away their wounded and shooting any South Vietnamese troops they found alive.	 คืนนั้นทั้งคืน เวียดกงเดินทางท่ามกลางต้นไม้ อุ้มร่างผู้บาดเจ็บของพวกเขา และยิงใส่กองทหารเวียดนามใต้ ที่พวกเขาพบว่ายังมีชีวิตอยู่
 I played dead.	 ผมแกล้งตาย
 And the Viet Cong come in and they kick my body.	 พวกเวียดกงเข้ามาและเตะร่างของผม
 One bullet will get through right here.	 กระสุนนัดหนึ่งจะยิงผ่านตรงนี้
 And suddenly I feel, oh, I'm still alive.	 และทันใดนั้นผมก็รู้สึก โอ้ ผมยังมีชีวิตอยู่
 No problem.	 ไม่มีปัญหา
 So I just play, still playing dead.	 ผมก็เลยแค่แกล้งตาย
 And then they move back and they withdraw.	 และเมื่อพวกเขาถอยไปและถอนกำลัง
 Cradling his rifle in his arms, Toan began trying to crawl toward Binh Gia.	 ตวนถือปืนไรเฟิลในมือ เขาเริ่มพยายามคลานกลับไปบินห์เจีย
 He was not found for three days.	 ไม่มีคนพบเขาเป็นเวลาสามวัน
 And one of the paratroop, he come to pick me up, and he said.	 และหนึ่งในกองทหารพลร่มมารับผมและพูดว่า
 "Oh it's horrible. He smell horrible.	 "โอ้ แย่ชะมัด เขากลิ่นแรงมาก
 Like a dead rat." And I look back at all the worms and ants around my wounds.	 อย่างกับหนูตาย" ผมก็มองไปที่หนอนกับมดที่อยู่รอบแผลของผม
 By that time, I have time to feel pain.	 ในตอนนั้น ผมมีเวลาที่จะรู้สึกเจ็บแล้ว
 Because all three days I'm trying to survive.	 เพราะตลอดสามวันผมพยายามที่จะมีชีวิตรอด
 When it was all over, five Americans had died at Binh Gia.	 เมื่อทุกอย่างจบลง ทหารอเมริกันห้านายตายที่บินห์เจีย
 Thirty-two Viet Cong bodies had been left on the battlefield.	 ร่างของพวกเวียดกง 32 ศพถูกทิ้งไว้ในสนามรบ
 Two hundred South Vietnamese were killed, 200 more were wounded.	 ชาวเวียดนามใต้ 200 คนถูกฆ่า อีกกว่า 200 คนได้รับบาดเจ็บ
 I'll never forget those sights.	 ผมจะไม่มีวันลืมภาพเหล่านั้นเลย
 Everywhere we went, we saw corpses of the Saigon soldiers.	 ทุกที่ที่เราไป เราเห็นศพของทหารไซ่ง่อน
 What it really said was they were capable of marshaling this kind of force.	 สิ่งที่พูดกันจริงๆ ก็คือ พวกเขาสามารถระดมกำลังแบบนี้ได้
 The Vietnamese officers I talked to in the Marine Corps figured they had six months before the end.	 เจ้าหน้าที่เวียดนาม ที่ผมคุยด้วยในหน่วยนาวิกโยธิน พบว่าพวกเขามีเวลาหกเดือนก่อนที่จะสิ้นสุด
 The big question after Binh Gia, an American officer at headquarters said, "is how a thousand or more enemy troops could wander around the countryside so close to Saigon without being discovered.	 "คำถามสำคัญหลังจากบินห์เจีย" เจ้าหน้าที่ชาวอเมริกันที่กองบัญชาการพูดว่า "คือกองทัพศัตรูมากกว่าพันคน มาเดินรอบๆ ชนบทที่ใกล้มากกับไซ่ง่อน โดยไม่ถูกพบได้อย่างไร
 That tells you something about this war." Hanoi was exultant.	 เรื่องนั้นบอกให้คุณรู้บางอย่างเกี่ยวกับสงครามนี้" ฮานอยดีอกดีใจมาก
 Ho Chi Minh called it "a little Dien Bien Phu." Le Duan was convinced his strategy was working.	 โฮจิมินห์เรียกมันว่า "เดียนเบียนฟูน้อย" เล สวนเชื่อว่ากลยุทธ์ของเขาได้ผล
 "The liberation war of South Vietnam has progressed by leaps and bounds," he said.	 "สงครามการปลดปล่อยเวียดนามใต้คืบหน้า ด้วยการกระโจนและกระโดด" เขากล่าว
 "After the battle of Ap Bac two years ago, the enemy knew it would be difficult to defeat us.	 "หลังจากการต่อสู้ในอั๊บบั๊กเมื่อสองปีก่อน ศัตรูรู้ว่าการเอาชนะเราเป็นเรื่องยาก
 After Binh Gia, the enemy realizes that he is in the process of being defeated by us." I believe the battle at Binh Gia was historic milestone in the war.	 หลังจากบินห์เจีย ศัตรูตระหนักว่า พวกเขาอยู่ระหว่างการถูกพวกเราโค่นลง" ผมเชื่อว่าการต่อสู้ที่บินห์เจีย เป็นเหตุการณ์ประวัติศาสตร์ในสงคราม
 If the Americans hadn't gotten involved, we would have entered Saigon in 1966.	 ถ้าทหารอเมริกันไม่ได้เข้ามาเกี่ยวข้อง เราคงเข้าไปในไซ่ง่อนในปี 1966
 I, Lyndon Baines Johnson, do solemnly swear...	 ผม ลินดอน เบนส์ จอห์นสัน ขอสาบานอย่างจริงจังว่า ผม ลินดอน เบนส์ จอห์นสัน ขอสาบานอย่างจริงจังว่า (วันที่ 20 มกราคม 1965)
 Twenty-six days after the Binh Gia battle ended and just a week after President Johnson's inauguration, McGeorge Bundy handed the president a memorandum.	 หลังจากการต่อสู้ที่บินห์เจียยุติลง 26 วัน และเพียงหนึ่งสัปดาห์หลังจากพิธีเข้ารับตำแหน่ง ของประธานาธิบดีจอห์นสัน แมคจอร์จ บันดี้ยื่นบันทึกให้ประธานาธิบดี
 I will to the best of my ability.	 ผมจะใช้ความสามารถของผมให้เต็มที่
 The current strategy was clearly not working, it said.	 บันทึกกล่าวว่า เห็นได้ชัดกลยุทธ์ปัจจุบันไม่ได้ผล
 The Viet Cong were on the move and on the rise, supplied and now steadily reinforced with soldiers from North Vietnam.	 พวกเวียดกงเป็นฝ่ายรุกและได้เปรียบ ได้รับสิ่งของและตอนนี้ได้รับการสนับสนุน อย่างมั่นคงด้วยทหารจากเวียดนามเหนือ
 If an independent South Vietnam was to survive, the United States needed to act fast.	 หากเวียดนามใต้ที่เป็นเอกราชจะรอดได้ สหรัฐอเมริกาจะต้องดำเนินการโดยเร็ว
 The administration faced two choices, Bundy said.	 ฝ่ายบริหารมีทางเลือกสองทาง บันดี้กล่าว
 It could go along as it had been going and try to negotiate some kind of face-saving settlement.	 อาจจะทำตามที่เคยทำมาก่อน และพยายามเจรจาข้อตกลงที่รักษาหน้า
 Or they could use still more American military power to force the North to abandon its goal of uniting the country.	 หรือพวกเขาอาจใช้กำลังทางทหารอเมริกันมากขึ้น เพื่อบังคับให้ฝ่ายเหนือ ละทิ้งเป้าหมายในการรวมประเทศ
 Bundy and McNamara favored that option.	 บันดี้และแมคนามาร่าเห็นด้วยกับทางเลือกนั้น
 Unless the president chose it, they said, South Vietnam would fall.	 พวกเขากล่าวว่า ถ้าประธานาธิบดี ไม่เลือกทางนั้น เวียดนามใต้ก็จะล่มสลาย
 "I don't think anything," Johnson told McNamara, "is going to be as bad as losing." Then, a little over a week later, guerrillas struck an American helicopter base at Pleiku in the Central Highlands, killing eight American advisors and wounding over 100 more.	 จอห์นสันบอกแมคนามาร่าว่า "ผมไม่คิดว่าอะไร จะแย่เท่ากับการพ่ายแพ้" จากนั้น เกินหนึ่งสัปดาห์เล็กน้อยต่อมา กองโจรโจมตีฐานทัพ เฮลิคอปเตอร์ของอเมริกาที่เปลคู ในที่ราบสูงภาคกลาง สังหารที่ปรึกษาชาวอเมริกันแปดคน และบาดเจ็บมากกว่า 100 คน
 Approximately 24 hours ago, the first attack in the Pleiku area...	 ประมาณ 24 ชั่วโมงที่แล้ว การโจมตีครั้งแรกในบริเวณเปลคู
 Johnson immediately approved an air strike on a North Vietnamese army barracks.	 จอห์นสันอนุมัติการโจมตีทางอากาศทันที ต่อค่ายทหารกองทัพเวียดนามเหนือ
 On February 10, 1965, the Viet Cong blew up a hotel in Qui Nhon, killing 23 Americans and pinning 21 more beneath the rubble.	 ในวันที่ 10 กุมภาพันธ์ 1965 เวียดกงระเบิดโรงแรมในควิโนห์ สังหารชาวอเมริกัน 23 คน และฝังร่างอีก 21 คนไว้ใต้เศษปูน
 Johnson ordered another airstrike.	 จอห์นสันสั่งการโจมตีทางอากาศอีก
 Anxiety about what seemed to be happening spread around the world.	 ความวิตกกังวลเกี่ยวกับ สิ่งที่กำลังเกิดขึ้นแพร่ขยายไปทั่วโลก
 France, which had spent nearly a century in Vietnam, now called for an end to all foreign involvement there.	 ฝรั่งเศสที่ใช้เวลาเกือบหนึ่งศตวรรษในเวียดนาม เรียกร้องให้ยุติ ความเกี่ยวข้องด้านต่างประเทศที่นั่นทั้งหมด
 The British prime minister urged restraint.	 นายกรัฐมนตรีของอังกฤษขอให้มีการยับยั้ง
 Many leaders of the president's own party agreed, though not in public.	 ผู้นำหลายคนในพรรค ของประธานาธิบดีเองก็เห็นด้วย แม้ไม่ใช่ต่อสาธารณะ
 In a private memorandum, Johnson's own vice president, Hubert Humphrey, warned him that widening the war would undercut the Great Society, damage America's image overseas, and end any hope of improving relations with the Soviet Union.	 ในบันทึกส่วนตัว ฮิวเบิร์ต ฮัมฟรีย์ รองประธานาธิบดีของจอห์นสัน เตือนเขาว่าการขยายสงคราม จะลดอำนาจของสังคมที่ยิ่งใหญ่ เตือนเขาว่าการขยายสงคราม จะลดอำนาจของสังคมที่ยิ่งใหญ่ ทำลายภาพพจน์ของอเมริกาในต่างประเทศ และยุติความหวังในการทำให้ ความสัมพันธ์กับสหภาพโซเวียตดีขึ้น
 Johnson never responded.	 จอห์นสันไม่ได้ตอบกลับไป
 Instead, on March 2, 1965, the United States began a systematic bombardment of targets in North Vietnam, code-named Operation Rolling Thunder.	 แต่ในวันที่ 2 มีนาคม 1965 สหรัฐอเมริกาเริ่มการโจมตีเป็นระบบ ต่อเป้าหมายในเวียดนามเหนือ โดยมีชื่อรหัสว่า ปฏิบัติการสายฟ้าฟาด ปฏิบัติการสายฟ้าฟาด
 It was meant to be a "mounting crescendo" of air raids, Ambassador Taylor wrote, intended to bolster morale in the South and destroy morale in the North.	 มันเป็นการค่อยๆ เพิ่มขึ้น ของการโจมตีทางอากาศ เอกอัครราชทูตเทย์เลอร์เขียนไว้ มุ่งที่จะสนับสนุนกำลังใจในฝ่ายใต้ และทำลายกำลังใจในฝ่ายเหนือ มุ่งที่จะสนับสนุนกำลังใจในฝ่ายใต้ และทำลายกำลังใจในฝ่ายเหนือ (ตันห์ ฮวา - วินห์ - เวียดนามเหนือ ดองฮอย - ดีเอ็มซี)
 The thesis behind Rolling Thunder, as I understood it, was that as we ratcheted up the tempo and the volume of this effort against the North Vietnamese, sooner or later they would cry uncle.	 แนวคิดเบื้องหลังกลยุทธ์สายฟ้าฟาด ตามที่ผมเข้าใจคือเป็นการที่เราเร่งจังหวะ และปริมาณของความพยายามนี้ ต่อเวียดนามเหนือ ไม่ช้าก็เร็วพวกเขาก็จะยอมแพ้
 And there'd be a pause, and we would begin to negotiate our way out of this situation.	 และจะมีการหยุดพัก (แซม วิลสัน) (กองทัพ) และเราจะเริ่มเจรจา ด้วยวิธีของเราต่อสถานการณ์นี้
 This became an article of faith.	 นี่กลายเป็นบทความแห่งความเชื่อมั่น
 And this article of faith was a fallacious assumption.	 และบทความแห่งความเชื่อมั่นนี้ เป็นข้อสันนิษฐานที่ผิดพลาด
 They weren't going to give up.	 พวกเขาจะไม่ยอมแพ้
 They read us better than we read them.	 พวกเขาอ่านเราได้ดีกว่าที่เราอ่านพวกเขา
 The president insisted on strict secrecy, the American people were not to be told that the administration had changed its policy from retaliatory airstrikes to systematic bombing, that he had, in fact, widened the war.	 ประธานาธิบดียืนกราน ให้เก็บเป็นความลับอย่างเคร่งครัด ประชาชนชาวอเมริกันต้องไม่ได้รับรู้ว่า ฝ่ายบริหารเปลี่ยนนโยบาย จากการโจมตีทางอากาศเพื่อตอบโต้ เป็นการทิ้งระเบิดเป็นระบบ และอันที่จริงแล้วเขาขยายวงสงคราม
 They jointly agreed that joint retaliatory action was required.	 พวกเขาเห็นด้วยร่วมกันว่า จำเป็นต้องมีการตอบโต้ร่วมกัน
 General Westmoreland, who had initially been hesitant about committing ground troops to Vietnam, now asked for two battalions of Marines, 3,500 men, to protect the Danang airbase from which fighter-bombers were hitting the North.	 นายพลเวสต์มอร์แลนด์ที่ลังเลในตอนแรก เกี่วกับการส่งกองทหารราบไปยังเวียดนาม ตอนนี้ขอกองทัพนาวิกโยธินสองกอง 3,500 นาย เพื่อปกป้องฐานทัพอากาศดานัง ที่เครื่องบินขับไล่ทิ้งระเบิดกำลังโจมตีฝ่ายเหนือ
 Ambassador Taylor, who had once called for ground troops, now objected to the whole idea.	 เอกอัครราชทูตเทย์เลอร์ ซึ่งเคยเรียกร้องกองทหารราบ ตอนนี้คัดค้านความคิดทั้งหมด
 "Once you put that first soldier ashore," he wrote, "you never know how many others are going to follow him." But the president felt he had no choice but to give Westmoreland what he asked for.	 เขาเขียนว่า "เมื่อคุณให้ทหารนายแรกขึ้นบก คุณจะไม่รู้เลยว่ามีอีกกี่คนที่จะตามเขามา" แต่ประธานาธิบดีรู้สึกว่าเขาไม่มีทางเลือก นอกจากให้ในสิ่งที่เวสต์มอร์แลนด์ร้องขอ นอกจากให้ในสิ่งที่เวสต์มอร์แลนด์ร้องขอ
 He knew he would be blamed if more American advisors died.	 เขารู้ว่าจะถูกกล่าวโทษ ถ้าที่ปรึกษาชาวอเมริกันตายเพิ่มอีก
 "I feel like a jackass caught in a Texas hailstorm," he complained.	 "ผมรู้สึกเหมือนคนโง่ติดในพายุลูกเห็บในเท็กซัส" เขาตัดพ้อ
 "I can't run, I can't hide, and I can't make it stop." In March of 1965, Johnson finally took the action he had managed to avoid for so long.	 "ผมวิ่งหนีไม่ได้ ซ่อนไม่ได้ และผมก็ทำให้มันหยุดไม่ได้" ในเดือนมีนาคม ปี 1965 ในที่สุดจอห์นสันมีการดำเนินการ ที่เขาเคยหลีกเลี่ยงมานาน
 He was putting American ground troops in Vietnam.	 เขาส่งกองทหารราบอเมริกันไปในเวียดนาม
 The government of South Vietnam was not even consulted.	 ไม่มีแม้แต่การปรึกษากับรัฐบาลของเวียดนามใต้
 The United States of America had larger considerations.	 สหรัฐอเมริกามีสิ่งตอบแทนที่มีค่ามากกว่า
 Clearly, we saw it in terms of the Cold War.	 เห็นได้ชัดว่าเราเห็นมัน ในรูปแบบของสงครามเย็น
 Assistant Secretary of Defense John McNaughton said...	 ผู้ช่วยรัฐมนตรีกระทรวงกลาโหม จอห์น แมคนอตันพูดว่า
 He said our interests there were 70% to avoid humiliation, 20% to contain China, and ten percent to help the Vietnamese.	 เขาบอกว่าผลประโยชน์ของเราที่นั่น เจ็ดสิบเปอร์เซ็นต์คือการหลีกเลี่ยงความเสียหน้า เขาบอกว่าผลประโยชน์ของเราที่นั่น เจ็ดสิบเปอร์เซ็นต์คือการหลีกเลี่ยงความเสียหน้า (โรเบิร์ต การ์ด) (เพนตากอน) ยี่สิบเปอร์เซ็นต์คือยับยั้งจีน และสิบเปอร์เซ็นต์คือการช่วยชาวเวียดนาม (ความลับสุดยอด ภาคผนวก - การดำเนินการสำหรับเวียดนามใต้)
 Johnson quietly told his good friend, Senator Richard Russell of Georgia, what was about to happen.	 จอห์นสันบอกเพื่อนที่ดีของเขา วุฒิสมาชิกริชาร์ด รัสเซลล์แห่งจอร์เจียเงียบๆ ถึงสิ่งที่กำลังจะเกิดขึ้น
 I guess we got no choice, but it scares the death out of me.	 ผมเดาว่าเราไม่มีทางเลือก แต่มันก็ทำให้ผมกลัวแทบตาย
 I think everybody's going to think, "We're landing the Marines.	 ผมคิดว่าทุกคนจะต้องคิดว่า (ลินดอน จอห์นสัน) (ประธานาธิบดีสหรัฐอเมริกา) "เราจะส่งนาวิกโยธินไป
 We're off to battle." Of course, if they come up there, they're going to get them in a fight.	 เราจะออกไปต่อสู้" แน่นอนว่าถ้าพวกเขามาที่นั่น พวกเขาจะต้องต่อสู้กัน
 And if they ruin those airplanes, everybody is going to give me hell for not securing them, just like they did last time they made a raid.	 และถ้าพวกเขาทำลายเครื่องบินเหล่านั้น ทุกคนจะต่อว่าผมที่ไม่ป้องกันเครื่องบินพวกนั้น เหมือนตอนที่พวกเขาทำครั้งที่แล้วที่พวกนั้นโจมตี
 Yeah.	 ใช่
 What do you... What do you think? Well, Mr. President, it scares the life out of me.	 คุณคิดว่ายังไง ท่านประธานาธิบดี มันทำให้ผมกลัวสุดๆ (สว. ริชาร์ด รัสเซลล์) (เดโมแครต-จอร์เจีย)
 But I don't know how to back up now.	 แต่ตอนนี้ผมไม่รู้ว่าจะถอยยังไง
 It looks to me like we just got in this thing, and there's no way out.	 สำหรับผมแล้วดูเหมือนเราเข้าไปในเรื่องนี้ และไม่มีทางออก
 I don't know.	 ไม่รู้สินะ
 Uh, Dick, the great trouble I'm under...	 ดิ๊ก ปัญหายิ่งใหญ่ที่ผมเผชิญ
 A man can fight if he can see daylight down the road somewhere.	 (ดานัง เวียดนามใต้ วันที่ 8 มีนาคม 1965) คนเราสามารถต่อสู้ได้ ถ้าเห็นแสงสว่างบนถนนสักแห่ง คนเราสามารถต่อสู้ได้ ถ้าเห็นแสงสว่างบนถนนสักแห่ง
 But there ain't no daylight in Vietnam.	 แต่มันไม่มีแสงสว่างในเวียดนาม
 There's not a bit.	 ไม่มีสักนิด
 On March 8, 1965, Dr. Phan Huy Quat, yet another prime minister of South Vietnam, called his chief of staff, Bui Diem.	 ในวันที่ 8 มีนาคม 1965 ดร. ฟาน ฮุย ควอต เป็นนายกรัฐมนตรีอีกคนของเวียดนามใต้ โทรหาบุ๋ย เดียม เสนาธิการของเขา
 And Dr. Quat said, "There are three Marine battalions landing in Danang right now." I was flabbergasted. I said, "But why?" So he calmed me down. He said that, "No, okay. We talk about it later.	 และดร.ควอตพูดว่า "ตอนนี้มีกองพันนาวิกโยธินสามกองขึ้นบกที่ดานัง" (บุ๋ย เดียม) (ทูตของเวียดนามใต้) ผมแปลกใจและตกใจมาก ผมพูดว่า "ทำไมล่ะ" เขาบอกให้ผมใจเย็น เขาพูดว่า "ไม่เป็นไร เราจะคุยเรื่องนี้ทีหลัง
 But right now, try to be brief and draft a communique, announcing the landing of three Marine battalions, and welcoming the landing in the same time." I was very unhappy.	 แต่ตอนนี้พยายามรวบรัด และร่างหนังสือแถลงการณ์ ประกาศเรื่องการขึ้นฝั่ง ของกองพันนาวิกโยธินสามกอง และต้อนรับการขึ้นฝั่งในเวลาเดียวกัน" ผมรู้สึกไม่ดีเอามากๆ
 The Marines were landing at Danang on the east coast of South Vietnam, some 100 miles south of the demilitarized zone that divided the North from the South.	 นาวิกโยธินขึ้นฝั่งที่ดานัง ทางชายฝั่งตะวันออกของเวียดนามใต้ ห่างออกไปทางใต้ 100 ไมล์ ของเขตปลอดทหาร ที่แบ่งแยกฝ่ายเหนือจากฝ่ายใต้
 They were prepared to fight their way ashore.	 พวกเขาเตรียมพร้อม ที่จะต่อสู้ในระหว่างทางขึ้นฝั่ง
 They did not need to.	 พวกเขาไม่จำเป็นต้องทำ
 What struck me was how beautiful Vietnam was to look at.	 สิ่งที่ผมสะดุดตาคือ เมื่อมองแล้วเวียดนามมีความสวยงามมาก (ขอต้อนรับนาวิกโยธินสหรัฐฯ)
 There were just these endless acres of these jade-green rice paddies.	 มีที่นากว้างสุดหูสุดตา ที่ปลูกข้าวสีเขียวเหมือนหยก
 And these lovely villages inside these groves of bamboo and palm trees.	 และหมู่บ้านที่น่ารักเหล่านี้ ด้านในป่าไผ่และต้นปาล์ม
 And way off in the distance these bluish jungled mountains, and they looked like Shangri-La.	 และห่างออกไปก็มีภูเขาที่มีป่าสีเขียว และดูเหมือนแชงกรีลา
 And I remember seeing this line of Vietnamese women, or schoolgirls I think they were.	 และผมจำได้ว่าเห็นแถวของผู้หญิงเวียดนาม (ฟิลิป คาปูโต้) (นาวิกโยธิน) หรือนักเรียนหญิงซึ่งผมคิดว่าน่าจะใช่
 They actually looked like angels come to earth or something like that.	 จริงๆ แล้วพวกเธอดูเหมือนนางฟ้า ที่ลงมาบนโลกหรืออะไรแบบนั้นเลย
 So it was really quite striking, but a little unsettling because...  ...so how can a place like this, so beautiful and so enchanting, be at war? My father was very happy.	 ดังนั้นมันน่าประทับใจมาก แต่ก็ไม่สบายใจเล็กน้อยเพราะ... เป็นไปได้อย่างไรที่สถานที่แบบนี้ ที่สวยงามและมีเสน่ห์มาก จะมีสงคราม พ่อของฉันดีใจมาก
 We're such a small and poor country and the Americans have decided to come in to save us not only with their money, their resources, but even with their own lives.	 เราเป็นประเทศเล็กและยากจนมาก และชาวอเมริกันตัดสินใจที่จะมาช่วยพวกเรา ไม่เพียงด้วยเงินและทรัพยากรของพวกเขา (มิตรภาพของเวียดนามและอเมริกาจงเจริญ) แต่แม้กระทั่งด้วยชีวิตของพวกเขาเอง
 We were very grateful. We thought the...	 เราซาบซึ้งมาก (ดวง วัน มาย) (ไซ่ง่อน) เราคิดว่า...
 Sure enough with this power, the Americans are going to win.	 ฝ่ายอเมริกาจะชนะด้วยพลังนี้แน่นอน
 Seeing foreign troops marching past his village, an old man emerged from his home shouting, "Vivent les Francais!" He thought the French had returned.	 เมื่อเห็นกองทหารต่างชาติ เดินผ่านหมู่บ้านของเขา ชายแก่ออกมาจากบ้านและตะโกนว่า "ฝรั่งเศสจงเจริญ" เขาคิดว่าฝรั่งเศสกลับมาอีกครั้ง
 "The problem around here," a Marine captain leading a patrol told a reporter, "is who the hell is who?" As a voting member of Saigon Mission Council, I was opposed to the entry of American ground combat forces.	 "ปัญหาที่เกิดแถวนี้" หัวหน้านาวิกโยธินที่นำ หน่วยลาดตระเวนบอกผู้สื่อข่าวว่า "ไม่รู้ใครเป็นใคร" ตามสมาชิกที่ลงคะแนนของสภาภารกิจของไซ่ง่อน ผมถูกคัดค้านไม่ให้เข้าร่วม กองกำลังต่อสู้ภาคพื้นดินของอเมริกา
 I felt if the Vietnamese had to beat them off with a bloody stump, they had to do it themselves.	 ผมรู้สึกว่าถ้าชาวเวียดนาม ต้องเอาชนะพวกเขาด้วยตอไม้ ผมรู้สึกว่าถ้าชาวเวียดนาม ต้องเอาชนะพวกเขาด้วยตอไม้ (แซม วิลสัน) (กองทัพ) พวกเขาต้องทำด้วยตัวเอง
 We had to do everything we humanly could to help them, but we could not win it for them.	 เราต้องทำทุกอย่างที่เราทำได้ อย่างมนุษย์ธรรมดาเพื่อช่วยพวกเขา แต่เราไม่สามารถเอาชนะมันเพื่อพวกเขาได้
 So, I think we crossed the River Styx at that point.	 ดังนั้นผมคิดว่าเราข้ามแม่น้ำแห่งความตายในจุดนั้น
 In the deep of every Vietnamese mind, foreigner is the invader.	 ในส่วนลึกของจิตใจชาวเวียดนามทุกคน ชาวต่างชาติคือผู้บุกรุก
 So, when the American come in, the Viet Cong can recruit more people to fight against the invader.	 ดังนั้นเมื่อชาวอเมริกันเข้ามา เวียดกงสามารถเกณฑ์คนได้มากขึ้น (ตรัน หง็อก ตวน) (นาวิกโยธินเวียดนามใต้) เพื่อต่อสู้กับผู้บุกรุก
 The first protest I went to against the war in Vietnam was a protest at a Dow Chemical facility.	 (ดาว เคมิคอล ยูเอสเอ) (ดาว) การประท้วงครั้งแรกที่ผมไป เพื่อต่อต้านสงครามในเวียดนาม เป็นการประท้วงที่โรงงานดาว เคมิคอล
 Dow was manufacturing napalm.	 ดาวเป็นผู้ผลิตระเบิดนาปาล์ม
 They were dropping napalm on villages in Vietnam.	 พวกเขาจะท้ิงระเบิดนาปาล์ม ใส่หมู่บ้านในเวียดนาม
 It was a very disappointing experience because only 40 people came.	 มันเป็นประสบการณ์ที่น่าผิดหวัง เพราะมีคนมาเพียงแค่ 40 คน (บิล ซิมเมอร์แมน) (มหาวิทยาลัยชิคาโก)
 And we seemed very out of place and very ineffectual, impotent, standing outside with 40 people.	 เราดูผิดที่ผิดทาง ไร้ประโยชน์ และไร้กำลังมาก ยืนอยู่ด้านนอกกับคน 40 คน
 Most Americans understood little about Indochina, rarely knew anyone actually involved in the fighting, saw no reason to question the government's assertion that the United States had vital interests 8,000 miles from home.	 ชาวอเมริกันส่วนใหญ่ แทบจะไม่เข้าใจเกี่ยวกับอินโดจีน แทบจะไม่รู้จักใครที่มีส่วนในการต่อสู้จริงๆ ไม่เห็นเหตุผลที่จะตั้งคำถาม กับการยืนยันของรัฐบาลว่า สหรัฐอเมริกามีผลประโยชน์สำคัญ ห่าง 8,000 ไมล์จากบ้านอย่างไร
 Still, there was a small but growing number of people who had begun to oppose the war for any number of reasons.	 แต่ยังมีคนจำนวนน้อยที่เพิ่มขึ้น ที่เริ่มจะต่อต้านสงครามด้วยเหตุผลต่างๆ (วันที่ 15 และ 16 ต.ค.) (ต่อต้านสงครามเวียดนาม)
 Because they thought it unjust or immoral, believed it was unconstitutional or simply not in the national interest.	 เพราะพวกเขาคิดว่า มันไม่ยุติธรรมหรือไร้ศีลธรรม เชื่อว่าไม่ถูกต้องตามรัฐธรรมนูญ หรือเพียงแค่ไม่ใช่ผลประโยชน์ของประเทศ
 ♪ Oh I marched to the battle Of New Orleans... ♪ Two weeks after the Marines landed at Danang, members of the University of Michigan faculty organized a night-long discussion between professors and some 3,000 students about the escalation of the war.	 (ไม่เอาสงครามอีก โป๊ปพอล) สองสัปดาห์หลังจากที่นาวิกโยธินขึ้นฝั่งที่ดานัง สมาชิกของมหาวิทยาลัยมิชิแกนได้จัด การอภิปรายตลอดคืนระหว่างพวกอาจารย์ และนักเรียน 3,000 คน เกี่ยวกับการขยายสงคราม
 The demonstration was called a teach-in because the idea originated with a group of university professors.	 การประท้วงถูกเรียกว่าเป็นการสอน เพราะแนวคิดเกิดจาก กลุ่มอาจารย์ในมหาวิทยาลัย
 What do you hope to accomplish? I'd like to open up communication between people and the government, because I believe that they are not telling us what is going on, and the people have the right to know, and we have the right to tell the government what we think.	 คุณหวังจะบรรลุเป้าหมายอะไร ผมต้องการเปิดการสื่อสาร ระหว่างประชาชนและรัฐบาล ผมต้องการเปิดการสื่อสาร ระหว่างประชาชนและรัฐบาล เพราะผมเชื่อว่าพวกเขาไม่ได้บอกพวกเรา ถึงสิ่งที่กำลังเกิดขึ้น เพราะผมเชื่อว่าพวกเขาไม่ได้บอกพวกเรา ถึงสิ่งที่กำลังเกิดขึ้น และประชาชนมีสิทธิ์ที่จะรู้ เรามีสิทธิ์ ที่จะบอกรัฐบาลว่าเราคิดอะไร (ถอนทหารสหรัฐฯ)
 Soon, there were teach-ins on most major university campuses.	 ในไม่ช้า มีการสอนแบบนี้ ในวิทยาเขตของมหาวิทยาลัยสำคัญส่วนมาก
 There is no morally wonderful way out.	 ไม่มีทางออกทางศีลธรรมที่ยอดเยี่ยม
 NYU in Manhattan, the University of Wisconsin in Madison, the University of California in Berkeley.	 เอ็นวายยูในแมนแฮตตัน มหาวิทยาลัยวิสคอนซินในเมดิสัน มหาวิทยาลัยแคลิฟอร์เนียในเบิร์กลีย์
 The teach-ins were really raucous affairs.	 การสอนเป็นเหตุการณ์ที่จริงจังมาก
 A lot of contention.	 มีการโต้แย้งมากมาย
 ...we want to discuss is what's wrong with the Vietnam War, and...	 เราต้องการอภิปรายสิ่งที่ไม่ถูกต้อง เกี่ยวกับสงครามเวียดนามและ...
 ♪ But I ain't marchin' Anymore ♪ Do you endorse the administration's policy in South Vietnam? Whole-heartedly.	 (ออกจากเวียดนาม) คุณเห็นด้วยกับนโยบาย ของฝ่ายบริหารในเวียดนามใต้หรือครับ เห็นด้วยที่สุดครับ
 There were plenty of times when people who were supportive of the war came to these teach-ins to try to give an alternative anticommunist point of view.	 มีหลายครั้งที่ประชาชนซึ่งสนับสนุนสงคราม มาที่การสอนพวกนี้เพื่อพยายามให้ความคิดเห็น ทางเลือกของฝ่ายต่อต้านคอมมิวนิสต์
 They were often shouted down.	 พวกเขามักถูกตะโกนใส่
 The bombing of the North and the Marines' arrival also drew protesters to Washington that spring.	 การทิ้งระเบิดของฝ่ายเหนือ และการมาถึงของนาวิกโยธิน ยังดึงดูดผู้ประท้วงมาที่วอชิงตันในฤดูใบไม้ผลินั้น (เวียดนามเพื่อชาวเวียดนาม)
 The demonstration was organized by the Students for a Democratic Society, the SDS.	 การประท้วงได้รับการจัดขึ้น... โดยนักเรียนเพื่อสังคมแห่งประชาธิปไตย เอส.ดี.เอส
 I saw SDS calling for a demonstration at the White House in the spring of 1965.	 ผมเห็นเอสดีเอสเรียกร้องให้มีการประท้วง ที่ทำเนียบขาวในฤดูใบไม้ผลิปี 1965
 I didn't want to go because I didn't want to be disappointed in the same way again and, you know, go all the way to Washington and stand outside the White House with 40 people.	 ผมไม่อยากไปเพราะผมไม่อยากผิดหวัง ในแบบเดียวกันอีกครั้งและเดินทางไปถึงวอชิงตัน ยืนด้านนอกทำเนียบขาวกับคน 40 คน
 Twenty-five thousand people attended that rally.	 มี 25,000 คนเข้าร่วมในการประท้วง
 And that suddenly told me and others I was working with at the time that it might be possible to build an antiwar movement.	 และเรื่องนั้นบอกผมทันที และคนอื่นๆ ที่ผมทำงานด้วยในตอนนั้น และเรื่องนั้นบอกผมทันที และคนอื่นๆ ที่ผมทำงานด้วยในตอนนั้น (ไม่เอานาปาล์ม เอาการเลือกตั้ง) มันเป็นไปได้ที่จะสร้าง ความเคลื่อนไหวเพื่อต่อต้านสงคราม (เทย์เลอร์จะหยุดหลอกลวง ชาวอเมริกันได้ไหม)
 It was quite astounding to think that he had that degree of commitment.	 มันน่าประหลาดใจที่คิดว่า เขามีความมุ่งมั่นในระดับนั้น
 And it made sense in what we knew of him, as drastic as it was.	 และมันก็มีเหตุผล... (ฌ็อง-มารี คร็อกเกอร์) (ซาราโทกาสปริงส์ นิวยอร์ก) ในสิ่งที่เรารู้จักเขา ที่รุนแรงแบบที่เคยเป็น
 Nothing Mogie Crocker's parents could say or do since Mogie had come home shook his determination to serve, and recent developments in Vietnam had only strengthened his resolve.	 พ่อแม่ของโมกี้ คร็อกเกอร์ ไม่สามารถพูดหรือทำอะไรได้ ตั้งแต่โมกี้กลับมาบ้าน เพื่อสลัดความตั้งใจของเขาที่จะรับใช้ชาติ และการพัฒนาล่าสุดในเวียดนาม ได้ทำให้การตัดสินใจของเขาแน่วแน่
 He wanted to become a paratrooper and get into combat.	 เขาต้องการเป็นทหารพลร่มและเข้าร่วมการต่อสู้
 His parents finally, reluctantly, agreed to let him go, and on March 15, a week after the first Marines landed at Danang, Denton Crocker, Jr. entered the United States Army.	 ในที่สุดพ่อแม่ของเขาก็ฝืนใจยอมตกลงให้เขาไป ในที่สุดพ่อแม่ของเขาก็ฝืนใจยอมตกลงให้เขาไป และในวันที่ 15 มีนาคม หนึ่งสัปดาห์ หลังจากที่นาวิกโยธินทีมแรกขึ้นบกที่ดานัง และในวันที่ 15 มีนาคม หนึ่งสัปดาห์ หลังจากที่นาวิกโยธินทีมแรกขึ้นบกที่ดานัง เดนตัน คร็อกเกอร์ จูเนียร์ เข้าร่วมกองทัพสหรัฐอเมริกา
 So Denton bounced down the steps one morning and was off to Fort Dix.	 เดนตันก็กระโดดลงบันไดในเช้าวันหนึ่ง และเดินทางไปที่ฟอร์ตดิกซ์
 It was in a way a sort of relief, actually, that the conflict and the anxiety over whether he would or would not go was done.	 จริงๆ แล้วมันก็ค่อนข้างโล่งอก ที่ความขัดแย้งและความวิตกกังวล เรื่องเขาจะไปหรือไม่ไปจบลงเสียที
 And he was happy.	 และเขาก็มีความสุข
 And we just tried to believe that this was the right thing for him to do.	 เราพยายามที่จะเชื่อว่า นี่เป็นสิ่งถูกต้องที่เขาต้องทำ
 In the early days, I wasn't very scared.	 ในช่วงแรกๆ ฉันไม่กลัวมากนัก
 But when I saw dead people, that scared me.	 แต่เมื่อฉันเห็นคนตาย ฉันจึงรู้สึกกลัว
 The Americans bombed a village for hours.	 ทหารอเมริกาทิ้งระเบิดใส่หมู่บ้านหลายชั่วโมง
 We ran over to see what had happened.	 เราวิ่งไปดูว่าเกิดอะไรขึ้น
 The village was unrecognizable.	 หมู่บ้านอยู่ในสภาพที่จำไม่ได้เลย (เล มินห์ เคว) (เวียดนามเหนือ)
 From then on, I knew that war had arrived.	 ตั้งแต่นั้นมา ฉันรู้ว่าสงครามได้มาถึงแล้ว
 Le Minh Khue was orphaned as a small girl, her parents victims of the brutal land reforms the communists had imposed.	 เล มินห์ เควกำพร้าตั้งแต่เด็ก พ่อแม่ของเธอเป็นเหยื่อของการปฏิรูป ที่ดินโหดร้ายที่กำหนดโดยคอมมิวนิสต์
 She was raised by her aunt and uncle, who encouraged her to read American literature.	 เธอได้รับการเลี้ยงดูจากลุงและป้าของเธอ ซึ่งสนับสนุนให้เธออ่านวรรณกรรมของอเมริกา
 She was 16 when Operation Rolling Thunder began.	 เธออายุ 16 ปีตอนที่ปฏิบัติการสายฟ้าฟาดเริ่มต้น
 My house was next to a home for the elderly.	 บ้านของฉันถัดจากบ้านสำหรับผู้สูงอายุ
 It was completely destroyed.	 ที่นั่นถูกทำลายอย่างสิ้นเชิง
 Bombs fell on the market and the school.	 ระเบิดตกลงที่ตลาดและโรงเรียน
 Then, a recruiter came asking for volunteers.	 จากนั้นเจ้าหน้าที่ที่เกณฑ์คนก็มา เพื่อขออาสาสมัคร
 My head was full of a strong spirit of adventure.	 ในหัวของฉันเต็มไปด้วย จิตวิญญาณแห่งการผจญภัยที่แรงกล้า
 But I was too young. You had to be 17.	 แต่ฉันอายุน้อยเกินไป คุณต้องมีอายุ 17 ปี
 So I lied about my age and signed up.	 ฉันเลยโกหกเรื่องอายุและสมัครไป
 Khue was assigned to an organization called the "Youth Shock Brigades Against the Americans for National Salvation," and along with thousands of other young people was sent south to work keeping open the Ho Chi Minh Trail.	 เควได้รับมอบหมายในองค์กรที่เรียกว่า กองพลเยาวชนต่อต้าน ทหารอเมริกันเพื่อการช่วยชาติ พร้อมกับเยาวชนคนอื่นๆ อีกหลายพันคน ถูกส่งไปทางใต้เพื่อทำงาน เพื่อคอยเปิดเส้นทางโฮจิมินห์
 Before I left, my uncle said, "American literature is very unique.	 ก่อนฉันจะไป ลุงของฉันพูดว่า "วรรณกรรมของอเมริกามีเอกลักษณ์มาก
 You should bring some with you." I loved American literature ever since, and in particular, I live Hemingway.	 เธอควรเอาติดตัวไปบ้างนะ" ฉันรักวรรณกรรมของอเมริกานับแต่นั้นมา ฉันชอบเฮมิงเวย์เป็นพิเศษ
 I learned from "For Whom the Bell Tolls." Like the resourcefulness of the man who destroys the bridge.	 ฉันเรียนรู้จากเรื่อง ฟอร์ ฮูม เดอะ เบล โทลส์ เหมือนความฉลาดของชายที่ทำลายสะพาน
 I saw how he coped with war, and I learned from that character.	 ฉันเห็นวิธีที่เขารับมือกับสงคราม และฉันเรียนรู้จากตัวละครนั้น
 As Johnson had feared, it quickly became clear that the bombing campaign alone was not working.	 ดังที่จอห์นสันกลัว เห็นได้ชัดเจนอย่างรวดเร็วว่า ลำพังการต่อสู้ด้วยการทิ้งระเบิดไม่ได้ผล
 Troops and supplies continued steadily to filter down the Ho Chi Minh Trail.	 กำลังพลและสิ่งของยังคง ผ่านเส้นทางโฮจิมินห์อย่างสม่ำเสมอ
 General Westmoreland and the Joint Chiefs called for more men, tens of thousands of them.	 นายพลเวสต์มอร์แลนด์และเสนาธิการร่วม เรียกร้องทหารเพิ่มจำนวนหลายหมื่นนาย
 The president was cautious.	 ประธานาธิบดีมีความระมัดระวัง
 He wanted to do "enough, but not too much," he said.	 เขากล่าวว่าเขาต้องการทำ "อย่างเพียงพอแต่ไม่มากเกินไป"
 But he quietly agreed to send two more Marine battalions and changed their mission from base security to active combat.	 แต่เขาตกลงอย่างเงียบๆ ที่จะส่ง กองพันนาวิกโยธินไปอีกสองกอง และเปลี่ยนภารกิจของพวกเขาจากการรักษา ความปลอดภัยฐานทัพเป็นการต่อสู้เชิงรุก
 For the first time, American troops were being asked to fight on their own in Vietnam.	 เป็นครั้งแรก กองทหารอเมริกันถูกขอ ให้สู้ด้วยตัวเองในเวียดนาม
 Johnson did not want that fact revealed to the American public either.	 จอห์นสันไม่ต้องการให้ข้อเท็จจริงนั้น เปิดเผยต่อสาธารณชนชาวอเมริกันเช่นกัน
 But the bombing of the North and rumors of harsher measures to come had heightened concern around the world.	 แต่การระเบิดของฝ่ายเหนือ และข่าวลือของมาตรการที่รุนแรงที่จะเกิดขึ้น ทำให้เกิดความกังวลเพิ่มขึ้นทั่วโลก
 UN Secretary-General U Thant had proposed a three-month ceasefire.	 อูตัน เลขาธิการสหประชาชาติ ได้เสนอการหยุดรบสามเดือน
 Great Britain, America's closest ally, publicly offered to reconvene the Geneva Talks that had divided Vietnam in 1954, with the goal of reuniting it.	 ประเทศอังกฤษ พันธมิตรที่สนิทที่สุดของอเมริกา ได้เสนอต่อสาธารณะ ที่จะเปิดประชุมใหม่ในการพูดคุยที่เจนีวา ที่แบ่งแยกเวียดนามในปี 1954 ด้วยเป้าหมายในการรวมประเทศ
 The people of South Vietnam be allowed to guide their own country...	 ประชาชนในเวียดนามใต้ ได้รับอนุญาตให้นำประเทศของตน
 On April 7, at Johns Hopkins University, Johnson sought to persuade the world of America's good intentions and again to calm American fears of a wider war.	 ในวันที่ 7 เมษายน ที่มหาวิทยาลัยจอนส์ฮอปกินส์ จอห์นสันต้องการโน้มน้าวโลก ถึงเจตนาที่ดีของอเมริกา และอีกครั้งเพื่อปลอบความกลัว ของชาวอเมริกันเรื่องสงครามที่ขยายวง
 In recent months, attacks on South Vietnam were stepped up.	 ในเดือนล่าสุด การโจมตีเวียดนามใต้เพิ่มขึ้น
 Thus, it became necessary for us to increase our response and to make attacks by air.	 ดังนั้น เราจึงจำเป็นต้องเพิ่มการตอบโต้ และทำการโจมตีทางอากาศ
 This is not a change of purpose.	 นี่ไม่ใช่การเปลี่ยนจุดประสงค์
 It is a change in what we believe that purpose requires.	 มันเป็นการเปลี่ยนสิ่งที่เราเชื่อว่า จุดประสงค์นั้นต้องการ
 Nothing was said about the new orders sending Marines directly into combat.	 ไม่มีคำพูดใดเกี่ยวกับคำสัั่งใหม่ ที่ส่งนาวิกโยธินไปต่อสู้โดยตรง
 Instead, the president called for "unconditional discussions" with Hanoi, and as an old New Dealer, proposed a massive development program for all of Southeast Asia.	 แต่ประธานาธิบดีเรียกร้อง ให้มีการพูดคุยกับฮานอยโดยไม่มีเงื่อนไข แต่ประธานาธิบดีเรียกร้อง ให้มีการพูดคุยกับฮานอยโดยไม่มีเงื่อนไข และในฐานะผู้ตกลงใหม่คนเก่า เสนอโครงการพัฒนาขนาดใหญ่ สำหรับเอเชียตะวันออกเฉียงใต้ทั้งหมด
 The vast Mekong River can provide food and water and power on a scale to dwarf even our own TVA.	 แม่น้ำแม่โขงที่กว้างใหญ่ สามารถให้อาหาร น้ำ และพลังงาน ในระดับที่ทำให้บริษัททีวีเอเล็กลงไปเลย
 I was outside of the village.	 ผมอยู่นอกหมู่บ้าน
 We're getting some fire from the village.	 เรากำลังจะไปเอาไฟจากหมู่บ้าน
 I had the little transistor radio.	 ผมมีวิทยุทรานซิสเตอร์เล็กๆ
 And I'm sitting there listening to LBJ.	 และผมก็นั่งตรงนั้นฟังปธน. พูด
 ...will use our power with restraint and with all the wisdom...	 จะใช้พลังของเราด้วยความยับยั้ยง และด้วยสติปัญญาทั้งหมด
 At the same time we got to lay some nape on the village.	 ในเวลาเดียวกันเราต้อง วางระเบิดนาปาล์มในหมู่บ้าน (ฟิลิป เบรดี้) (ที่ปรึกษาของนาวิกโยธิน)
 So I'm calling in the nape and listening to the president talk peace.	 ผมจึงเรียกให้ทิ้งระเบิดนาปาล์ม และฟังประธานาธิบดีพูดถึงสันติภาพ
 We will try to keep conflict from spreading.	 เราจะพยายามไม่ให้ความขัดแย้งแพร่ขยาย
 It was surreal.	 เหมือนฝันจริงๆ
 We have no desire to devastate that which the people of North Vietnam have built with toil and sacrifice.	 เราไม่ได้ปรารถนาที่จะทำลายล้าง สิ่งที่ประชาชนของเวียดนามเหนือ เราไม่ได้ปรารถนาที่จะทำลายล้าง สิ่งที่ประชาชนของเวียดนามเหนือ ได้สร้างขึ้นด้วยความตรากตรำและเสียสละ ได้สร้างขึ้นด้วยความตรากตรำและเสียสละ
 This war, like most wars, is filled with terrible irony.	 สงครามนี้เหมือนสงครามส่วนใหญ่ ที่เต็มไปด้วยการเย้ยหยันแย่ๆ
 What do the people of North Vietnam want? Hanoi denounced the president's offer as a trick.	 ประชาชนของเวียดนามเหนือต้องการอะไร ฮานอยยกเลิกข้อเสนอ ของประธานาธิบดีเพื่อเป็นอุบาย
 Johnson's advisors and the Joint Chiefs of Staff continued to debate how many men would actually be needed and how rapidly they should be deployed.	 ที่ปรึกษาของจอห์นสันและคณะเสนาธิการร่วม ยังคงอภิปรายถึงจำนวนทหารที่จำเป็นจริงๆ และควรเรียกประจำการพวกเขาเร็วแค่ไหน
 Meanwhile, the president sent the first Army combat troops to the country.	 ในเวลาเดียวกัน ประธานาธิบดีส่ง กองทหารต่อสู้ของทัพบกไปยังประเทศนั้น
 It was increasingly clear that the United States was in it for the long haul.	 เป็นที่ชัดเจนเพิ่มขึ้นว่า สหรัฐอเมริกาเข้าร่วมในระยะยาว
 You can't just be a neutral witness to something like war.	 คุณไม่สามารถเป็นพยานที่เป็นกลางได้... (โจ กัลโลเวย์) (นักหนังสือพิมพ์) ต่อบางสิ่งเช่นสงคราม
 It crawls down your throat.	 มันคืบคลานลงสู่คอของคุณ
 It eats you alive from the inside and the out.	 มันกลืนกินคุณทั้งเป็นจากข้างในและข้างนอก
 It's not something that you can stand back and be neutral and objective and all of those things we try to be as reporters, journalists, photographers.	 ไม่ใช่สิ่งที่คุณสามารถถอยหลังและเป็นกลาง ไม่ลำเอียงและทุกอย่างที่เราพยายามจะเป็น ในฐานะผู้สื่อข่าว นักหนังสือพิมพ์ ช่างภาพ
 It doesn't work that way.	 มันไม่เป็นเช่นนั้น
 They're fast and they're real quick... And check it out...	 การป้องกันและพวกเขาเร็วมาก ต้องตรวจสอบ
 The growing presence of American combat troops in Vietnam attracted flocks of journalists.	 การเพิ่มขึ้นของกองทหารสู้รบ ของอเมริกาในเวียดนาม ดึงดูดกลุ่มนักหนังสือพิมพ์
 There was no press censorship, as there had been in World War II.	 ไม่มีการเซ็นเซอร์สื่อ อย่างที่เคยมีในสงครามโลกครั้งที่สอง
 Reporters just had to agree to follow military guidelines so as not to compromise the security of ongoing operations.	 ผู้สื่อข่าวแค่ต้องตกลงที่จะทำตาม คำแนะนำทางทหารเท่านั้น เพื่อที่จะไม่ทำลายความปลอดภัย ของปฏิบัติการที่ดำเนินอยู่
 It was dangerous work.	 มันเป็นงานที่อันตราย
 More than 200 journalists and photographers would die covering the fighting in Southeast Asia.	 นักหนังสือพิมพ์และช่างภาพ มากกว่า 200 คนอาจเสียชีวิต ในการทำข่าวการต่อสู้ในเอเชียตะวันออกเฉียงใต้
 Joseph Lee Galloway was a young UPI reporter from Refugio, Texas.	 โจเซฟ ลี กัลโลเวย์์เป็นผู้สื่อข่าวอายุน้อย ของยูพีไอจากรีฟิวจีโอ เท็กซัส โจเซฟ ลี กัลโลเวย์์เป็นผู้สื่อข่าวอายุน้อย ของยูพีไอจากรีฟิวจีโอ เท็กซัส (บัตรสื่อมวลชน) (ชื่อ โจเซฟ กัลโลเวย์์ เจอาร์)
 He stopped in Saigon just long enough to get his credentials.	 เขาหยุดพักที่ไซ่ง่อนนานพอ ที่จะได้รับหนังสือรับรอง
 Then he headed for Danang.	 จากนั้นเขามุ่งหน้าไปดานัง
 The Marines originally came ashore there to guard the airbase.	 ตอนแรกนาวิกโยธินขึ้นฝั่งที่นั่น เพื่อปกป้องฐานทัพอากาศ
 And they quickly figured out you can't just guard an airbase.	 และพวกเขาพบอย่างรวดเร็วว่า คุณไม่สามารถป้องกันฐานทัพอากาศได้
 You've got to spread out because they're going to mortar it, they're going to shoot rockets.	 คุณต้องขยายออกไป เพราะพวกเขาจะยิงปืนครกใส่ พวกเขาจะยิงจรวดใส่
 So you've got to reach out 15 or 20 miles.	 ดังนั้นคุณต้องออกไป 15 หรือ 20 ไมล์
 That means you've got to run operations that far out.	 หมายความว่าคุณต้องทำการปฏิบัติการที่ไกลออกไป
 And once you're doing that, you're no longer guarding an airbase...	 เมื่อคุณทำเช่นนั้น คุณก็จะไม่ได้ป้องกันฐานทัพอากาศ
 ...you're operating in hostile territory.	 คุณจะปฏิบัติการในเขตแดนของศัตรู
 No matter how strong you are, if you aren't familiar with the battlefield, with the climate, with the local customs, it will be very tough.	 ไม่ว่าคุณจะแข็งแกร่งเพียงใด ถ้าคุณไม่คุ้นเคยกับสนามรบ กับสภาพอากาศ กับประเพณีในท้องถิ่น มันจะเป็นเรื่องยากมาก
 The Americans were very tall and slow.	 ทหารอเมริกันตัวสูงและช้ามาก (เหงียน ถั่ญ เซิน) (กองทัพเวียดนามเหนือ)
 They weren't as quick as our soldiers.	 พวกเขาไม่เร็วเท่าทหารของเรา
 It wasn't so much the Viet Cong that were intimidating at that point as it was the terrain.	 ในจุดนั้นเวียดกงไม่ได้น่ากลัวมาก เท่ากับภูมิประเทศ
 Going from Point A to Point B in the jungle was so difficult.	 การไปจากจุดเอถึงจุดบี... (ฟิลิป คาปูโต้) (นาวิกโยธิน) ในป่าเป็นเรื่องยากมาก ในป่าเป็นเรื่องยากมาก
 As it happened to me once, it took four hours to move a half a mile, cutting through this bush with machetes.	 มันเคยเกิดขึ้นกับผมครั้งหนึ่ง ผมใช้เวลาสี่ชั่วโมง เพื่อเดินทางครึ่งไมล์ โดยตัดผ่านพุ่มไม้ด้วยมีดสปาร์ตา
 The Viet Cong knew the terrain far better than the Marines did, and ran circles around them.	 เวียดกงรู้จักภูมิประเทศดีกว่านาวิกโยธิน และวิ่งวนรอบพวกเขา
 Fort Dix, June 10, 1965.	 ฟอร์ตดิกซ์ วันที่ 10 มิถุนายน 1965
 Dear Mom, Basic is now all over and I am presently waiting for orders.	 ถึงคุณแม่ พื้นฐานจบหมดแล้วและตอนนี้ผมกำลังรอคำสั่ง
 Waiting for orders could be very dull, but I have found there are excellent chances to do some reading.	 การรอคำสั่งเป็นเรื่องน่าเบื่อมาก แต่ผมพบว่ามีโอกาสที่ดี ที่จะได้อ่านหนังสือ
 Recently I have read Wuthering Heights, Animal Farm, Seven Pillars of Wisdom, and Lord Jim.	 ช่วงนี้ผมอ่านเรื่อง วัทเทอริง ไฮท์ส แอนิมอล ฟาร์ม เซเว่น พิลลาร์ ออฟ วิสดอม และลอร์ดจิม
 I hope you are all well.	 ผมหวังว่าทุกคนจะสบายดีนะ
 Love, Mogie.	 ด้วยรัก โมกี้
 Mogie Crocker was allowed two weeks at home before shipping out to Vietnam.	 โมกี้ คร็อกเกอร์ได้รับอนุญาต ให้กลับบ้านสองสัปดาห์ ก่อนที่จะเดินทางไปเวียดนาม
 We were at dinner one evening just talking, I guess, in generalities about the war and the general situation.	 เราทานมื้อค่ำกันในเย็นวันหนึ่ง แค่คุยกันเรื่องทั่วไปเกี่ยวกับสงคราม และสถานการณ์ทั่วไป
 And Mogie said, "Of course if I were a Vietnamese, I would be on the side of the Viet Cong." That... I puzzled over that.	 โมกี้พูดว่า "แน่นอนว่าถ้าผมเป็นชาวเวียดนาม ผมคงอยู่ฝ่ายเวียดกง" ฉันคิดหนักเกี่ยวกับเรื่องนั้น
 I suppose relating like to our American Revolution that he saw their need for their own freedom.	 ฉันว่าการเทียบกับการปฏิรูปของอเมริกา ที่เขาเห็นความต้องการเพื่อเสรีภาพของพวกเขา
 But as an American citizen, he saw the larger picture of trying to prevent communism.	 แต่ในฐานะพลเมืองชาวอเมริกัน เขาเห็นภาพที่ใหญ่กว่า ของการพยายามป้องกันลัทธิคอมมิวนิสต์
 I remember one night in particular he and I were up late.	 ฉันจำได้ว่ามีอยู่คืนหนึ่ง เขากับฉันอยู่จนดึก
 And he suddenly leaned his head in his hands.	 ทันใดนั้นเขากุมหัวตัวเอง
 And he said, "I don't want to go back." I was dumbstruck.	 และพูดว่า "ผมไม่อยากกลับไป" ฉันตะลึงจนพูดไม่ออก
 And said to him, "But this is what you want to do." It had never occurred to me that he was torn about this, that he was afraid and yet was determined to go.	 และพูดกับเขาว่า "แต่นี่เป็นสิ่งที่เธออยากทำนะ" ฉันไม่เคยเห็นเขากังวลเรื่องนี้มาก่อนเลย เขากลัวแต่ก็ยังมุ่งมั่นที่จะไป
 In South Vietnam, things were steadily growing worse.	 ในเวียดนามใต้ เรื่องต่างๆ เลวร้ายลงอย่างคงที่
 In May, the Viet Cong, supported now by four regiments of North Vietnamese regulars, approximately 5,000 men, were destroying the equivalent of a South Vietnamese battalion every week.	 ในเดือนพฤษภาคม เวียดกง ที่ได้รับการสนับสนุนโดยกองทัพ พลทหารเวียดนามเหนือสี่กอง ประมาณ 5,000 นาย กำลังทำลายกองพันของเวียดนามใต้ทุกสัปดาห์
 South Vietnam now seemed only weeks from complete collapse.	 ตอนนี้เวียดนามใต้ดูจะล่มสลาย อย่างสมบูรณ์ในอีกไม่กี่สัปดาห์เท่านั้น
 Desperate, General Westmoreland requested tens of thousands of more American troops right away.	 นายพลเวสต์มอร์แลนด์ที่สิ้นหวังมีคำขอ กองทัพทหารอเมริกันเพิ่มอีกหลายหมื่นทันที
 But neither the continuing bombing nor the growing likelihood of full-scale American intervention seemed to intimidate Hanoi.	 แต่ทั้งการทิ้งระเบิดต่อไป หรือความเป็นไปได้ ของการแทรกแซงเต็มที่ของอเมริกา ดูจะไม่ทำให้ฮานอยกลัว
 Le Duan, having failed to win the war before the United States sent in ground troops, was now persuaded the American public, like the French public before them, would eventually weary of a costly, bloody war being waged so far from home.	 เล สวนที่ไม่สามารถเอาชนะในสงครามได้ ก่อนที่สหรัฐอเมริกาจะส่งกองทหารราบมา ตอนนี้ถูกโน้มน้าวโดยสาธารณชนอเมริกัน เหมือนสาธารณชนฝรั่งเศสก่อนหน้าพวกเขา ตอนนี้ถูกโน้มน้าวโดยสาธารณชนอเมริกัน เหมือนสาธารณชนฝรั่งเศสก่อนหน้าพวกเขา ในที่สุดเขาก็เป็นกังวลเกี่ยวกับ สงครามราคาแพงและนองเลือด ในที่สุดเขาก็เป็นกังวลเกี่ยวกับ สงครามราคาแพงและนองเลือด ซึ่งมีการต่อสู้ไกลจากบ้านมาก
 By contrast, he said, "The North will not count the cost." Le Duan's confidence was bolstered by the help American intervention had forced the Soviet Union and China to offer him.	 ในทางตรงข้่าม เขาบอกว่า "ฝ่ายเหนือจะไม่นับค่าใช้จ่าย" ความมั่นใจของเล สวนได้รับการสนับสนุน จากความช่วยเหลือที่การแทรกแซงของอเมริกา ความมั่นใจของเล สวนได้รับการสนับสนุน จากความช่วยเหลือที่การแทรกแซงของอเมริกา ได้บังคับให้สหภาพโซเวียตและจีนเสนอให้กับเขา ได้บังคับให้สหภาพโซเวียตและจีนเสนอให้กับเขา
 Moscow agreed to supply vast amounts of modern weaponry and materiel.	 มอสโกตกลงที่จะส่ง อาวุธสมัยใหม่และวััตถุดิบจำนวนมาก
 Hanoi would eventually become the most heavily defended city on Earth.	 ในที่สุดฮานอยจะเป็นเมือง ที่ได้รับการปกป้องอย่างแน่นหนาที่สุดในโลก
 And China agreed to send support troops, freeing North Vietnamese soldiers for combat in the South.	 และจีนตกลงส่งกองทหารสนับสนุนมา เพื่อปลดปล่อยทหารเวียดนามเหนือ สำหรับการต่อสู้ในฝ่ายใต้
 320,000 Chinese would eventually serve behind the lines in the North.	 ในที่สุดทหารจีน 320,000 นาย จะทำหน้าที่หลังเส้นในฝ่ายเหนือ
 "We will fight," Le Duan promised, "whatever way the United States wants." In June of 1965, Secretary McNamara, the Secretary of Defense, came out to Saigon.	 "เราจะต่อสู้" เล สวนสัญญา "ไม่ว่าด้วยทางไหนที่สหรัฐฯ ต้องการ" ในเดือนมิถุนายน ปี 1965 รัฐมนตรีแมคนามาร่า... (จอห์น เนโกรพอนเต้) (สถานทูตสหรัฐ) รัฐมนตรีกระทรวงกลาโหมมาที่ไซ่ง่อน
 There were a lot of captains and majors and lieutenants.	 มีนาวาเอก พลเรือตรี และเรือโทหลายนาย
 And every person said to Mr. McNamara, "The situation is so dire we must bring in United States forces." So, whatever doubts we may have had, whatever people may say after the fact, I recall distinctly at the time telling the Secretary of Defense that I thought we needed to bring troops in there.	 และทุกคนพูดกับแมคนามาร่าว่า "สถานการณ์แย่มาก เราต้องนำกองกำลังของสหรัฐมา" ดังนั้น ไม่ว่าเราอาจจะสงสัยอะไรก็ตาม ไม่ว่าประชาชนจะพูดอะไรก็ตาม หลังจากข้อเท็จจริง ตอนนั้นผมจำได้อย่างชัดเจนว่า ได้บอกรัฐมนตรีกระทรวงกลาโหมว่า ผมคิดว่าเราต้องนำกองทัพไปที่นั่น
 For three weeks, the president and his advisors argued over how to respond to Westmoreland's urgent request for more troops, differing mostly over how many should be sent how fast.	 เป็นเวลาสามสัปดาห์ ประธานาธิบดีและที่ปรึกษาของเขา เร่งว่าจะตอบสนองอย่างไร ต่อคำขอเร่งด่วนของเวสต์มอร์แลนด์ ที่ขอกองทหารเพิ่มอีก ความแตกต่างส่วนใหญ่ เรื่องจำนวนที่ควรส่งไปเร็วแค่ไหน
 Undersecretary of State, George Ball, made the argument against further escalation.	 จอร์จ บอล ปลัดกระทรวงการต่างประเทศ โต้แย้งการยกระดับเพิ่ม
 He told the president the war could not be won.	 เขาบอกประธานาธิบดีว่า เราไม่อาจเอาชนะสงครามได้
 The American people will grow weary of it.	 ประชาชนชาวอเมริกันจะเริ่มกังวลถึงสงคราม
 Our troops will get bogged down "in the jungles and rice paddies," he warned, "while we slowly blow the country to pieces." No one else agreed.	 กองทหารของเราจะจมปลัก "ในป่าและนาข้าว" เขาเตือน "ในขณะที่เราทำลายประเทศเป็นชิ้นๆ อย่างช้าๆ" ไม่มีคนอื่นเห็นด้วย
 In the end, Johnson sent Westmoreland 50,000 men.	 ท้ายที่สุด จอห์นสันส่ง ทหาร 50,000 นายให้เวสต์มอร์แลนด์
 But he pledged another 50,000 by the end of 1965, and still more if they were needed.	 และเขาขออีก 50,000 นายภายในสิ้นปี 1965 และเพิ่มอีกหากจำเป็นต้องใช้พวกเขา
 When the Americans come in 1965, everything mess up in South Vietnam.	 เมื่อทหารอเมริกันมาในปี 1965 ทุกอย่างยุ่งเหยิงในเวียดนามใต้
 Nobody know about the country, the people, the ground they fought.	 ไม่มีใครรู้เกี่ยวกับประเทศหรือประชาชน (ตรัน หง็อก ตวน) (นาวิกโยธินเวียดนามใต้) พื้นที่ที่เขาต่อสู้
 I think it's, it's a big mistake.	 ผมคิดว่า เป็นข้อผิดพลาดครั้งใหญ่
 Hold your fire! Hold your fire.	 วางอาวุธลง อย่าเพิ่งยิง
 Does the fact that you are sending additional forces to Vietnam imply any change in the existing policy of using American forces to guard American installations and to act as an emergency backup? It does not imply any change in policy whatever.	 ข้อเท็จจริงที่คุณส่งกองกำลังเพิ่มเติมไปเวียดนาม บอกเป็นนัยถึงการเปลี่ยนแปลงในนโยบายที่มีอยู่ ของการใช้กองกำลังอเมริกัน เพื่อป้องกันค่ายทหารของอเมริกา และเพื่อทำหน้าที่เป็นการสำรองยามฉุกเฉินใช่ไหม ไม่ได้บอกเป็นนัย ถึงการเปลี่ยนแปลงนโยบายอะไรทั้งนั้น
 It does not imply any change of objective.	 ไม่ได้บอกเป็นนัยถึงการเปลี่ยนแปลงวัตถุประสงค์
 The month of June saw soldiers here taking what appears to be...	 เดือนมิถุนายน เห็นทหารที่นี่ พูดคุยถึงสิ่งที่ดูเหมือนจะเป็น...
 Most television reports from Vietnam echoed the newsreels Americans had flocked to see during the Second World War. Enthusiastic, unquestioning, good guys fighting and defeating bad guys.	 รายงานทางโทรทัศน์ส่วนใหญ่จากเวียดนาม สะท้อนถึงภาพยนตร์ข่าวที่ชาวอเมริกันรวมตัวกันดู ในช่วงสงครามโลกครั้งที่สอง คนดีที่กระตือรือล้น ไร้คำถาม ที่ต่อสู้และเอาชนะคนไม่ดี
 But at dinnertime on August 5, 1965, Americans saw another side of the war.	 แต่ในเวลามื้อค่ำของวันที่ 5 สิงหาคม 1965 ชาวอเมริกันเห็นอีกด้านของสงคราม
 We're on the outskirts of the village of Cam Ne with elements of the 1st Battalion...	 เราอยู่รอบนอกของหมู่บ้านในแคมเน พร้อมกองพันที่หนึ่งจำนวนเล็กน้อย
 CBS correspondent Morley Safer and his crew went on patrol with Marines near Danang.	 มอร์ลีย์ เซเฟอร์นักข่าวของซีบีเอส และคณะของเขา ไปลาดตระเวนกับนาวิกโยธินใกล้ดานัง
 Their orders were first to search a cluster of four villages for caches of arms and rice meant for the enemy and then to destroy them all.	 คำสั่งแรกของพวกเขา คือการค้นหากลุ่มหมู่บ้านสี่แห่ง คำสั่งแรกของพวกเขา คือการค้นหากลุ่มหมู่บ้านสี่แห่ง เพื่อหาที่เก็บอาวุธและข้าวที่มีความหมายต่อศัตรู เพื่อหาที่เก็บอาวุธและข้าวที่มีความหมายต่อศัตรู จากนั้นก็ทำลายของพวกนั้นให้หมด
 This is what the war in Vietnam is all about.	 นี่เป็นสิ่งที่เกิดขึ้นในสงครามเวียดนาม
 The old and the very young.	 คนแก่และคนหนุ่มสาว
 The Marines have burned this old couple's cottage because fire was coming from here.	 นาวิกโยธินได้เผากระท่อม ของคู่สามีภรรยาวัยชราคู่นี้ เพราะมีการยิงปืนมาจากตรงนี้
 And now when you walk into the village you see no young people at all.	 ตอนนี้เมื่อคุณเดินเข้าไปในหมู่บ้าน คุณจะไม่เห็นคนหนุ่มสาวเลย
 The day's operation burned down 150 houses, wounded three women, killed one baby, wounded one Marine, and netted these four prisoners.	 ปฏิบัติการของวันนั้นเผาบ้าน 150 หลัง ผู้หญิงได้รับบาดเจ็บสามราย ทารกเสียชีวิตหนึ่งราย นาวิกโยธินได้รับบาดเจ็บหนึ่งนาย และจับนักโทษไปสี่คน
 Today's operation is the frustration of Vietnam in miniature.	 ปฏิบัติการในวันนี้ เป็นความไม่พอใจของเวียดนามในภาพย่อส่วน
 There is little doubt that American firepower can win a military victory here.	 มีความสงสัยเล็กน้อยว่ากำลังอาวุธของอเมริกา สามารถได้รับชัยชนะทางทหารที่นี่ได้
 But to a Vietnamese peasant whose home is a... Means a lifetime of backbreaking labor, it will take more than presidential promises to convince him that we are on his side.	 แต่สำหรับชาวนาเวียดนามที่บ้านของเขา หมายถึงแรงงานที่เหน็ดเหนื่อยมาตลอดชีวิต จะต้องใช้มากกว่าคำสัญญาของประธานาธิบดี ที่จะทำให้เขาเชื่อว่าเราอยู่ฝ่ายเขา
 The next morning, the president called his friend Frank Stanton, the head of CBS.	 เช้าวันถัดมา ประธานาธิบดีโทรหาเพื่อนของเขา แฟรงก์ สแตนตัน หัวหน้าของซีบีเอส
 "Hello, Frank, this is your president.	 "สวัสดีแฟรงก์ นี่ประธานาธิบดีของคุณนะ
 Are you trying to fuck me?" Safer had defaced the American flag, Johnson said.	 คุณกำลังพยายามเล่นงานผมหรือไง" จอห์นสันบอกว่า เซเฟอร์ทำให้ธงชาติอเมริกาเสียหาย
 He was probably an agent of the Kremlin, had to be fired.	 เขาอาจจะเป็นสายลับของเครมลิน ต้องถูกไล่ออก
 The Marines claimed Safer had provided a Zippo lighter and asked the Marines to burn the hut for the camera.	 นาวิกโยธินอ้างว่าเซเฟอร์ให้ไฟแช็กซิปโป้ และขอให้นาวิกโยธินเผากระท่อมต่อหน้ากล้อง
 A major at the Danang Marine press office called CBS the "Communist Broadcasting System." But after the operation, Safer interviewed some of the Marines who'd burned Cam Ne.	 พันตรีนายหนึ่งที่สำนักงานข่าวนาวิกโยธินของดานัง เรียกซีบีเอสว่า "ระบบออกอากาศของคอมมิวนิสต์" แต่หลังจากการปฏิบัติการ เซเฟอร์สัมภาษณ์นาวิกโยธินบางนายที่เผาแคมเน
 Do you ever have any private thoughts, any private regrets about some of these people you are leaving homeless? I feel no remorse. I don't imagine anybody else does.	 คุณมีความคิดหรือความเสียใจส่วนตัว คุณมีความคิดหรือความเสียใจส่วนตัว เกี่ยวกับพวกคนที่คุณทำให้พวกเขาไร้บ้านไหม เกี่ยวกับพวกคนที่คุณทำให้พวกเขาไร้บ้านไหม ผมไม่รู้สึกเสียใจนะ ผมไม่คิดว่าคนอื่นจะเสียใจด้วย
 You can't expect to do your job and feel pity for these people.	 คุณหวังว่าจะทำหน้าที่ของตัวเอง และรู้สึกสงสารคนพวกนั้นไม่ได้หรอก
 When some viewers registered their shock, Westmoreland admitted, "We have a genuine problem which will be with us as long as we are in Vietnam.	 เมื่อผู้ชมบางรายแสดงความตกใจ เวสต์มอร์แลนด์ยอมรับว่า "เรามีปัญหาอย่างแท้จริง ที่จะอยู่กับเราตราบใดที่เราอยู่ในเวียดนาม
 Commanders must exercise restraint unnatural to war and judgment not often required of young men." You kind of thought at first that it was going to be like the GIs, you know, rolling through Paris after the liberation.	 ผู้บัญชาการต้องใช้การยับยั้งที่ผิดปกติต่อสงคราม และการตัดสินที่มักไม่จำเป็นของคนหนุ่ม" คุณอาจคิดในตอนแรกว่า มันจะต้องเป็นเหมือนจีไอ นึกออกไหม ที่เคลื่อนผ่านปารีสหลังจากการปลดปล่อย
 Well, you know, it sure didn't work out that way.	 รู้ไหม มันไม่ได้ออกมาเป็นแบบนั้น
 I can remember once going in this one ville.	 ผมจำได้ว่าเคยไปที่หมู่บ้านนี้
 And I remember finding this entire Vietnamese family cowering in a bunker.	 และผมจำได้ว่าพบชาวเวียดนามทั้งครอบครัวนี้ กำลังหมอบอยู่ในหลุมหลบภัย
 And they were terrified of us.	 พวกเขากลัวเรา
 And I remember thinking to myself, I said, "Well, I wonder if back in the colonial days, when the Redcoats barged into Ipswich, Massachusetts, or wherever, if this is how Americans must have felt looking at these foreign soldiers coming in here." The Viet Cong have terrorized you, and have burned your homes.	 ผมจำได้ว่าพูดกับตัวเองในใจว่า "ผมสงสัยว่าถ้าย้อนกลับไปยุคล่าอาณานิคม... (ฟิลิป คาปูโต้) (นาวิกโยธิน) เมื่อทหารอังกฤษเข้าไปที่อิปสวิช แมสซาชูเซตส์ หรือที่ไหนก็ตาม ถ้านี่เป็นสิ่งที่ทหารอเมริกันต้องรู้สึก ตอนมองดูทหารต่างชาติพวกนี้มาที่นี่" เวียดกงคุกคามคุณและเผาบ้านของคุณ
 We are here to help you.	 เรามาที่นี่เพื่อช่วยคุณ
 To show how much we are able to protect you, we are going to have the Air Force hit some Viet Cong on the other side of the valley.	 เพื่อแสดงว่าเราสามารถปกป้องคุณได้มากแค่ไหน เราจะให้กองทัพอากาศ โจมตีเวียดกงที่อยู่อีกด้านของหุบเขา
 That will be at 10:30.	 ซึ่งจะเป็นตอนเวลาสิบโมงครึ่ง
 Dear Mom and Dad, I am now with the 1st Brigade, 101st Airborne Division in Vietnam.	 ถึงพ่อและแม่ ตอนนี้ผมอยู่ในกองพลน้อยที่หนึ่ง กองพลส่งทางอากาศที่ 101 ในเวียดนาม
 What is taking place in America? We who are in Vietnam find these protests very hard to comprehend, and many people here are quite bitter about them.	 (เขตของตำรวจ ประชาชนเวียดนามต้องการสันติ) เกิดอะไรขึ้นในอเมริกา เราที่อยู่ในเวียดนามคิดว่าการประท้วงพวกนี้ ยากมากที่จะเข้าใจ และหลายคนที่นี่ค่อนข้างไม่พอใจพวกเขา
 The belief I have in our present policy has been completely confirmed by what I have seen here.	 ความเชื่อที่ผมมีในนโยบายปัจจุบันของเรา ได้รับการยืนยันอย่างแน่นอนโดยสิ่งที่ผมได้เห็นที่นี่
 My chief worry is that these pacifist bleatings might affect even a small change in government policy at a time when we appear close to success.	 ความกังวลหลักของผมคือ เสียงบ่นของนักสันติเหล่านี้ อาจมีผลต่อการเปลี่ยนแปลงเล็กน้อย ในนโยบายของรัฐบาล ในเวลาที่เราดูใกล้จะประสบความสำเร็จ
 As Vietnam began to be more and more chaotic, I certainly wondered very much whether we should be there.	 เมื่อเวียดนามเริ่มจะวุ่นวายขึ้นเรื่อยๆ ฉันสงสัยมากว่าทำไมเราควรไปที่นั่น
 But I never expressed that to him.	 แต่ฉันไม่เคยแสดงความคิดนั้นกับเขา
 That's one of those conflicts that's just too difficult to bring up, or at least it was for me.	 นั่นเป็นหนึ่งในข้อขัดแย้ง ซึ่งยากเกินไปที่จะยกขึ้นมาพูด หรืออย่างน้อยที่สุดก็สำหรับฉัน
 We were all excited about the arrival of the 1st Cavalry Division, an experimental unit.	 เราทุกคนตื่นเต้นเกี่ยวกับการมาถึง ของกองทหารม้าที่หนึ่ง เราทุกคนตื่นเต้นเกี่ยวกับการมาถึง ของกองทหารม้าที่หนึ่ง หน่วยทดลอง
 They've been trained in air-mobile warfare using these helicopters to the absolute maximum benefit.	 พวกเขาได้รับการฝึกในการสู้รบในอากาศ โดยใช้เฮลิคอปเตอร์พวกนี้ให้เกิดประโยชน์สูงสุด
 They're moving their artillery by helicopter, jumping it, leapfrogging troops, chasing the enemy, driving him crazy.	 พวกเขาย้ายปืนใหญ่ โดยเฮลิคอปเตอร์ กระโดดลงมา กองทหารที่กระโดดและวิ่งไล่ศัตรู ทำให้เขารู้สึกคลั่ง
 This is something new, and it's going to change the way we do war.	 นี่เป็นเรื่องใหม่ และจะเปลี่ยนวิธีที่เราทำสงคราม (โจ กัลโลเวย)์ (นักหนังสือพิมพ์)
 In September of 1965, the newly created 1st Cavalry Division, 16,000 men, 1600 vehicles, 435 helicopters, had begun arriving at An Khe, a massive base carved out of the grasslands at the edge of the Central Highlands.	 ในเดือนกันยายน ปี 1965 กองทหารม้าที่หนึ่ง ซึ่งเพิ่งสร้างขึ้นใหม่ ทหาร 16,000 นาย พาหนะ 1,600 คัน เฮลิคอปเตอร์ 435 ลำ เริ่มมาถึงที่อานเข่ ฐานทัพขนาดใหญ่ที่ทำเป็นรูปทุ่งหญ้า ฐานทัพขนาดใหญ่ที่ทำเป็นรูปทุ่งหญ้า ที่ริมที่ราบสูงตอนกลาง
 Its heliport would come to be called the "Golf Course." As the 1st Cavalry got used to its new surroundings, thousands of North Vietnamese regulars were slipping south into the Highlands along the Ho Chi Minh Trail, joining Viet Cong units already in place.	 ลานขึ้นลงของเฮลิคอปเตอร์ของที่นั่น ถูกเรียกว่าสนามกอล์ฟ เมื่อกองทหารม้าที่หนึ่ง คุ้นเคยกับสภาพแวดล้อมใหม่ ทหารเวียดนามเหนือหลายพันนายเข้าไปฝ่ายใต้ ในที่ราบสูงข้างๆ เส้นทางโฮจิมินห์ เพื่อเข้าร่วมหน่วยเวียดกงที่ประจำการอยู่แล้ว (แม่น้ำเอีย ดราง - เปลเม่ เทือกเขาชูปอง)
 They established their own base on and around a jumble of thickly forested mountains and ravines south of the Ia Drang River.	 (แม่น้ำเอีย ดราง - เปลเม่ เทือกเขาชูปอง) พวกเขาสร้างฐานทัพของตัวเองบนความยุ่งเหยิง พวกเขาสร้างฐานทัพของตัวเองบนความยุ่งเหยิง ของภูเขาและหุบเขาป่าหนาทึบ ทางใต้ของแม่น้ำเอียดรัง ของภูเขาและหุบเขาป่าหนาทึบ ทางใต้ของแม่น้ำเอียดรัง
 On the evening of October 19, communist commandos slipped to within 40 yards of the perimeter wire of the U.S. Special Forces outpost at Plei Me, which was defended by a 12-man team of U.S. Green Berets, 14 A.R.V.N., and some 400 mountain tribesmen.	 ในตอนเย็นของวันที่ 19 ตุลาคม คอมมานโดของคอมมิวนิสต์เข้ามา ภายใน 40 หลาของเส้นรอบวง คอมมานโดของคอมมิวนิสต์เข้ามา ภายใน 40 หลาของเส้นรอบวง ของด่านหน้าของกองกำลังพิเศษสหรัฐที่เปลเม่ ซึ่งป้องกันโดยทีมกรีนเบอเรต์ของสหรัฐ จำนวน 12 นาย ทหารเออาร์วีเอ็น 14 นาย และชาวเขา 400 คน
 Nine of the 12 Green Berets were hit.	 ทหารเก้านายจาก 12 ในทีมกรีนเบอเรต์ถูกยิง
 They managed to hold out for two days before 15 more Green Berets and 160 South Vietnamese Rangers were helicoptered in, commanded by Major Charles Beckwith, known to his fellow soldiers as Chargin' Charlie.	 พวกเขาสามารถตรึงไว้ได้สองวัน ก่อนที่กรีนเบอเรต์อีก 15 นาย และทหารจู่โจมของเวียดนามใต้อีก 160 นาย ถูกส่งมาทางเฮลิคอปเตอร์ บัญชาการโดย พันตรีชาลส์ เบ็ควิท เพื่อนทหารของเขาเรียกว่า ชาร์ลีจอมจู่โจม
 The next day, Joe Galloway managed to talk a helicopter pilot into flying him into the besieged camp.	 วันถัดมา โจ กัลโลเวย์ คุยกับนักบินเฮลิคอปเตอร์ ให้พาเขาบินไปที่ค่ายซึ่งถูกโอบล้อมด้วยศัตรู
 That's where I met Major Charles Beckwith.	 ผมได้พบกับพันตรีชาลส์ เบ็ควิทที่นั่น
 He said, "I need everything in the world.	 เขาพูดว่า "ผมต้องการทุกอย่างในโลก
 And what has the Army in its wisdom sent me but a godforsaken reporter?" He drug me over and showed me a 30-caliber air-cooled machine gun.	 และกองทัพใช้สติปัญญาส่งอะไรมาให้ผม นอกจากผู้สื่อข่าวที่น่าหดหู่ เขามอมยาผมและแสดงให้ผมดู ปืนกลระบายความร้อนด้วยอากาศลำกล้อง 30
 He showed me how to load it, how to clear a jam.	 เขาแสดงวิธีการโหลดปืนและการเคลียร์ลำกล้อง
 "You can shoot the little brown men outside the wire," Beckwith told Galloway.	 "คุณสามารถยิงคนผิวน้ำตาลตัวเล็ก ด้านนอกเส้นลวดได้" เบ็ควิทบอกกัลโลเวย์
 "You may not shoot the little brown men inside the wire. They are mine." And I'm sitting there thinking, "Ah, I'm a civilian noncombatant." I tried that line on Beckwith and he said, "Ain't no such thing in these mountains, son." For nearly a week, the North Vietnamese launched assault after assault on Plei Me.	 "คุณไม่สามารถยิงคนผิวน้ำตาลตัวเล็ก ด้านในเส้นลวดได้ พวกเขาเป็นคนของผม" ผมนั่งคิดอยู่ตรงนั้นว่า "ผมเป็นแค่พลเรือนทั่วไป" ผมลองพูดแบบนั้นกับเบ็ควิทและเขาพูดว่า "ไม่มีเรื่องแบบนั้นในภูเขาแถบนี้หรอก เจ้าหนุ่ม" เป็นเวลาเกือบสัปดาห์ เวียดนามเหนือมีการโจมตี ครั้งแล้วครั้งเล่าที่เปลเม่
 It was only after American bombs and napalm turned the surrounding terrain into a moonscape that the enemy withdrew.	 เพียงหลังจากระเบิดและนาปาล์มของอเมริกา ได้เปลี่ยนภูมิประเทศรอบๆ ให้เป็นพื้นผิวดวงจันทร์ ที่ศัตรูถอนตัวไป
 What kind of fighters are the Viet Cong that you met here? I would give anything to have 200 of them under my command.	 เวียดกงที่คุณพบที่นี่เป็นนักสู้ประเภทไหน เวียดกงที่คุณพบที่นี่เป็นนักสู้ประเภทไหน (พันตรีชาลส์ เอ. เบ็ควิท) ผมจะยอมแลกทุกอย่าง ให้ได้พวกเขา 200 นายมาอยู่ใต้บัญชาการ
 They're the finest soldiers I've ever seen.	 พวกเขาเป็นทหาร ที่ยอดเยี่ยมที่สุดเท่าที่เคยเห็นมา
 -The Viet Cong. -That's right.	 - เวียดกงเหรอ - ใช่แล้ว
 They're dedicated, and they're good soldiers.	 พวกเขาทุ่มเทและเป็นทหารที่ดีมาก
 They're the best I've ever seen.	 พวกเขายอดเยี่ยมที่สุดเท่าที่เคยพบ
 Despite the losses, his men had suffered at Plei Me, the North Vietnamese commander, General Chu Huy Man, was eager for another confrontation with the Americans.	 ทั้งที่พ่ายแพ้ คนของเขาทรมานที่เปลเม่ ผู้บัญชาการของเวียดนามเหนือ นายพลชู ฮุย มัน กระตือรือร้นที่จะเผชิญหน้ากับทหารอเมริกันอีก
 He was determined to learn how to fight them.	 เขาตั้งใจที่จะเรียนรู้วิธีต่อสู้กับพวกเขา
 Reinforcements streaming down the Ho Chi Minh Trail to the Ia Drang Valley included a newly minted second lieutenant, Lo Khac Tam, who had volunteered to fight in the South.	 กองกำลังเสริมเดินทางไปตามเส้นทางโฮจิมินห์ ไปยังหุบเขาเอียดรัง รวมถึงร้อยตรีที่ได้รับแต่งตั้งใหม่ โล คั๊ก ตัม ผู้ที่อาสาไปต่อสู้ในฝ่ายใต้
 I had a girlfriend, but I didn't tell her about it, because it was a secret mission.	 (โล ค๊ัก ตัม) (กองทัพเวียดนามเหนือ) ผมไม่ได้บอกเธอเรื่องนี้ เพราะมันเป็นภารกิจลับ
 After we got to the Chu Pong mountains, I realized that to be an officer I would have to learn to command.	 หลังจากที่เราไปถึงภูเขาชูปอง ผมรู้ว่าในการเป็นเจ้าหน้าที่ ผมจะต้องเรียนรู้ที่จะบัญชาการ
 And the best way to learn would be in battle.	 และวิธีที่ดีที่สุดในการเรียนรู้จะอยู่ในการต่อสู้
 On the morning of November 14, 1965, 1st Cavalry helicopters belonging to the 1st Battalion of the 7th Regiment, George Armstrong Custer's old outfit, flew west along the Ia Drang toward the Chu Pong Massif, looking for the enemy.	 (หุบเขาเอียดรัง) ในตอนเช้าของวันที่ 14 พฤศจิกายน 1965 เฮลิคอปเตอร์ทหารม้าที่หนึ่ง ซึ่งเป็นของกองพันที่หนึ่งของกองทหารที่เจ็ด หน่วยปฏิบัติการเก่า ของจอร์จ อาร์มสตรอง คัสเตอร์ บินไปทางตะวันตกข้างเอียดรัง ไปยังเทือกเขาชูปอง เพื่อมองหาศัตรู
 Their commander, Kentucky-born Korean-War veteran Lieutenant Colonel Hal Moore, had been told there was a large enemy base camp somewhere on its slopes.	 ผู้บัญชาการของพวกเขา ทหารผ่านศึกสงครามเกาหลีที่เกิดในเคนทักกี พันโทฮัล มัวร์ ได้รับแจ้งว่ามีค่ายศัตรูขนาดใหญ่ ที่ไหนสักแห่งบนที่ลาด
 His orders were to take his understrength outfit, 29 officers and just 411 men, find the enemy and kill him.	 คำสั่งของเขาคือนำหน่วยปฏิบัติการที่มีกำลังไม่มาก เจ้าหน้าที่ 29 นายและเพียง 411 คน ไปค้นหาศัตรูและฆ่าเขา
 There were two clearings large enough for Moore to bring in eight choppers at once.	 มีที่โล่งสองแห่งซึ่งใหญ่พอสำหรับมัวร์ ที่จะนำเฮลิคอปเตอร์แปดลำจอดพร้อมกัน
 He chose the one closest to the mountain, Landing Zone X-Ray.	 เขาเลือกที่โล่งที่ใกล้ที่สุดกับภูเขา โซนลงจอดเอ็กซเรย์ (เทือกเขาชูปอง โซนลงจอดเอ็กซเรย์)
 Moore made a point of leading from the front.	 มัวร์เป็นผู้นำจากแนวหน้า
 He was the first man off the first chopper.	 เขาเป็นคนแรกที่ลงจากเฮลิคอปเตอร์ลำแรก
 He sent four six-man squads 100 yards in every direction.	 เขาส่งหน่วยรบที่มีหกนายสี่กอง ไป 100 หลาในทุกทิศทาง
 The Ia Drang Valley was so beautiful, one soldier remembered, it reminded him of a national park back home.	 ทหารนายหนึ่งจดจำได้ว่า หุบเขาเอียดรังสวยงามมาก มันทำให้เขานึกถึงอุทยานแห่งชาติที่บ้านเกิด
 Within minutes, Moore's men captured a deserter.	 ภายในไม่กี่นาที คนของมัวร์จับทหารหนีทัพ
 Terrified and trembling, he said there were three battalions of soldiers on the mountain, 1600 men.	 ที่หวาดกลัวและตัวสั่น เขาพูดว่ามีกองพันทหารสามกอง ในภูเขา ทหาร 1,600 นาย
 They wanted very much to kill Americans, he said, but so far had been unable to find any.	 เขาบอกว่าพวกเขาอยากฆ่าทหารอเมริกันมาก แต่ถึงตอนนี้ยังไม่สามารถหาได้
 Moore quickly set up a command post behind one of the huge termite mounds that dotted the clearing.	 มัวร์ตั้งที่บัญชาการขึ้นอย่างรวดเร็ว ด้านหลังเนินจอมปลวกขนาดใหญ่ที่อยู่ในที่โล่ง
 It would take until mid-afternoon for all of his men to be ferried in.	 การส่งทหารทั้งหมดของเขามา คงใช้เวลาจนถึงช่วงกลางของตอนบ่าย
 He had no time to waste.	 เขาเสียเวลาไม่ได้
 "We needed to get off the landing zone and get at them before they could hit us," Moore remembered.	 "เราต้องออกจากโซนลงจอดและจัดการพวกเขา "เราต้องออกจากโซนลงจอดและจัดการพวกเขา ก่อนที่พวกเขาจะโจมตีเรา" มัวร์จำได้
 He sent two companies up the slope toward the hidden enemy.	 เขาส่งกองร้อยสองกองไปที่ทางลาด เพื่อไปหาศัตรูที่ซ่อนอยู่
 Most of the North Vietnamese, like the Americans, were new to combat.	 ทหารเวียดนามส่วนใหญ่ก็เหมือนทหารอเมริกัน คือไม่คุ้นเคยกับการต่อสู้
 They were ordered to fix bayonets.	 พวกเขาถูกสั่งให้ซ่อมดาบปลายปืน
 It was a modern battle, but we were told the bayonet symbolized our fighting spirit, attached to the barrels of our rifles.	 สงครามนี้เป็นการต่อสู้สมัยใหม่ แต่เราถูกบอกว่าดาบปลายปืน เป็นสัญลักษณ์จิตวิญญาณแห่งการต่อสู้ของเรา (โล คั๊ก ตัม) (กองทัพเวียดนามเหนือ) ที่ติดกับกระบอกปืนไรเฟิลของเรา
 Colonel Moore had no way of knowing that instead of 1600 enemy soldiers on the mountain, there were 3,000, seven times his strength.	 ผู้พันมัวร์ไม่มีทางรู้ได้เลยว่า แทนที่จะเป็นทหารของศัตรู 1,600 นายบนภูเขา กลับมีถึง 3,000 นาย ซึ่งเป็นเจ็ดเท่าของกำลังของเขา
 Within minutes, the Americans found themselves under attack from hundreds of North Vietnamese soldiers.	 ภายในไม่กี่นาที ทหารอเมริกันพบว่าตนเอง อยู่ภายใต้การโจมตี จากทหารเวียดนามเหนือหลายพันนาย
 In the fighting, an overeager second lieutenant led his platoon of 28 men too far away from the rest of his company and was surrounded.	 ในการต่อสู้ ร้อยตรีที่กระตือรือล้นเกินไป นำกลุ่มทหาร 28 นายไปไกลเกินไป จากคนที่เหลือในกองร้อยของเขา นำกลุ่มทหาร 28 นายไปไกลเกินไป จากคนที่เหลือในกองร้อยของเขา และถูกโอบล้อม
 The lieutenant was killed.	 ร้อยตรีคนนั้นถูกสังหาร
 The sergeant who took his place was shot through the head.	 จ่าที่รับหน้าที่แทนเขาถูกยิงทะลุศีรษะ
 By late afternoon, only seven of the trapped platoon's men were still capable of firing back.	 ภายในบ่ายแก่ๆ มีเพียงทหารเจ็ดนาย ของกลุ่มที่ติดกับ ยังคงสามารถยิงกลับไปได้
 Moore was now engaged in three simultaneous struggles, to defend the landing zone, attack the North Vietnamese, and find a way to rescue his trapped patrol.	 ตอนนี้มัวร์เข้าร่วมในการต่อสู้พร้อมกันทั้งสามทาง เพื่อป้องกันโซนลงจอด โจมตีเวียดนามเหนือ และหาทางช่วยเหลือหน่วยลาดตระเวนที่ติดกับ
 That night, Joe Galloway again managed to talk his way onto a chopper, taking ammunition and water to the besieged Americans.	 คืนนั้น โจ กัลโลเวย์สามารถ ขอขึ้นเฮลิคอปเตอร์ได้อีกครั้ง คืนนั้น โจ กัลโลเวย์สามารถ ขอขึ้นเฮลิคอปเตอร์ได้อีกครั้ง โดยนำอาวุธปืนและน้ำ ไปยังทหารอเมริกันที่ถูกศัตรูล้อม โดยนำอาวุธปืนและน้ำ ไปยังทหารอเมริกันที่ถูกศัตรูล้อม
 As the helicopter approached the battlefield, Galloway was sitting on a crate of grenades, peering out into the darkness.	 เมื่อเฮลิคอปเตอร์ไปถึงสนามรบ กัลโลเวย์นั่งอยู่ที่ลังระเบิดมือ มองออกไปในความมืด
 And I could see these little pin pricks of light coming down the mountain.	 และผมเห็นจุดแสงเล็กๆ พวกนี้ มาจากภูเขา
 This was the enemy approaching for the next day's attacks.	 นี่เป็นการเดินทางของศัตรู เพื่อการโจมตีในวันถัดไป
 We flew in there.	 เราบินไปที่นั่น
 As they pulled on out, it was dead dark.	 ตอนที่พวกเขาออกไป มันมืดมาก
 And we're lying there waiting for someone to come tell us what to do.	 และพวกเขาหมอบอยู่ที่นั่น รอให้มีคนมาบอกเราว่าต้องทำอะไร
 And the next morning, all of a sudden the bottom fell out.	 และเช้าวันถัดมา ทันใดนั้นก็เกิดเรื่องร้ายแรงขึ้น
 There was an explosion of fire.	 มีการยิงกันปะทุขึ้นมา
 The noise is horrendous, unimaginable.	 เสียงดังกึกก้องเกินจินตนาการ
 And in the middle of all of this, you know, I just flattened out on the ground because all that was being fired seemed to be about two, two-and-a-half feet off the ground.	 และท่ามกลางเรื่องพวกนี้ทั้งหมด ผมได้แต่หมอบราบอยู่บนพื้น เพราะทุกอย่างที่กำลังถูกยิงดูเหมือนว่า จะอยู่ห่างจากพื้นประมาณสองฟุตครึ่ง
 Hundreds of enemy soldiers hurled themselves at the Americans.	 ทหารของศัตรูหลายร้อยนายพุ่งไปที่ทหารอเมริกัน
 They wore webbed helmets camouflaged with grass, and as they came, blowing whistles, screaming, they looked like little trees, one American remembered.	 พวกเขาใส่หมวกที่มีสายรัด อำพรางด้วยหญ้า เมื่อพวกเขามาโดยเป่านกหวีด กู่ร้อง พวกเขาดูเหมือนต้นไม้เล็กๆ ทหารอเมริกันนายหนึ่งจำได้
 They were trying to overrun us.	 พวกเขาพยายามที่จะบุกรุกเรา
 And they came close.	 และพวกเขาเข้ามาใกล้
 They came close.	 พวกเขาเข้ามาใกล้ๆ
 But we had two things going for us.	 แต่เรามีสองอย่างที่เกิดขึ้นเพื่อเรา
 We had a great commander and great soldiers.	 เรามีผู้บัญชาการและทหารที่ยอดเยี่ยม
 And we had air and artillery support out the yin-yang.	 และเรามีกองสนับสนุนทางอากาศ กับปืนใหญ่จำนวนมาก
 We had it, and they didn't.	 เรามีของ พวกเขาไม่มี
 But using that air and artillery support could be dangerous.	 แต่การใช้การสนับสนุนทางอากาศ และปืนใหญ่อาจเป็นอันตราย
 Each of Moore's units carefully marked its position with smoke to keep from being mistaken for the enemy by American airmen overhead.	 แต่ละหน่วยของมัวร์ ทำเครื่องหมายตำแหน่งด้วยควันอย่างระวัง เพื่อป้องกันไม่ให้เข้าใจผิดว่าเป็นศัตรู โดยนักบินอเมริกันที่อยู่ด้านบน
 We had to get close.	 เราต้องเข้าไปใกล้ๆ
 If we didn't, we would be killed right away.	 ถ้าเราไม่ไป เราจะถูกฆ่าทันที
 Some 18,000 artillery shells would be called in over the course of the battle, some of them landing just 25 yards from Moore's own men.	 กระสุนปืนใหญ่ 18,000 นัดถูกนำมาใช้ ในเส้นทางของการต่อสู้ พวกเขาบางส่วนลงพื้น ห่างเพียง 25 หลาจากคนของมัวร์
 Helicopter gunships fired 3,000 rockets into the enemy.	 เฮลิคอปเตอร์ติดอาวุธ ยิงจรวด 3,000 ลูกใส่ศัตรู
 The forward air controller called for every available aircraft in South Vietnam to come and help.	 ผู้ควบคุมการสู้รบส่วนหน้า เรียกเครื่องบินที่ว่างทุกลำในเวียดนามใต้ ให้มาช่วย
 Warplanes, including B-52 long-range strategic bombers, were stacked at 1,000-foot intervals above the battlefield, from 7,000 to 35,000 feet, impatiently awaiting targets to strafe, or bomb, or burn.	 เครื่องบินรบ รวมถึงเครื่องบินทิ้งระเบิด เชิงกลยุทธ์ระยะไกล บี-52 เรียงซ้อนกันที่ระยะห่าง 1,000 ฟุต เหนือสนามรบ จาก 7,000 ถึง 35,000 ฟุต รอเป้าหมายอย่างไม่อดทน เพื่อยิง วางระเบิด หรือเผา
 "By God," Moore said, "they sent us over here to kill communists and that's what we're doing." I looked up, and there were two jets aiming directly at our command post.	 "โดยพระเจ้า" มัวร์กล่าว "พวกเขาส่งเรามาที่นี่เพื่อฆ่าคอมมิวนิสต์ และนั่นเป็นสิ่งที่เรากำลังทำอยู่" ผมมองขึ้นไป มีเครื่องบินเจ็ตสองลำ มุ่งตรงมาที่บัญชาการของเรา
 He's dropped two cans of napalm and it's coming toward us, loblolly, end over end.	 เขาทิ้งระเบิดนาปาล์มสองลูก และมันตรงมาหาเรา ต้นสน พลิกกลับด้าน
 And these kids, two or three of 'em, plus a sergeant, had dug a hole or two over on the edge.	 และเด็กพวกนี้สองหรือสามคน รวมจ่าอีกนาย ได้ขุมหลุมสองหลุมไว้ที่ขอบ
 And I looked as the thing exploded...	 และผมดูในขณะที่สิ่งต่างๆ ระเบิด
 And two of them were dancing in that fire.	 และพวกมันสองคนก็เต้นในเปลวไฟนั้น
 And there's a rush, a roar, from the air that's being consumed and drawn in as this, this hell come to earth is burning there.	 และมีการเร่งรีบ การกู่ร้อง จากอากาศที่กำลังถูกใช้และดึงไป จากอากาศที่กำลังถูกใช้และดึงไป ตอนที่นรกนี้มายังโลกที่กำลังไหม้อยู่ ตอนที่นรกนี้มายังโลกที่กำลังไหม้อยู่
 And as that dies back a little, then you can hear the screams.	 และเมื่อสิ่งนั้นตายไปเล็กน้อย จากนั้นคุณถึงสามารถได้ยินเสียงกรีดร้อง
 And someone yells, "Get this man's feet." And I reach down and the boots crumble, and the flesh is cooked off of his ankles.	 และมีคนตะโกน "เก็บเท้าของผู้ชายคนนี้" ผมก้มลงไปและรองเท้าบูทขาดวิ่น เนื้อตรงข้อเท้าของเขาถูกย่างสุก
 And I feel those bones in the palms of my hands.	 และผมรู้สึกถึงกระดูกในอุ้งมือของผม
 I can feel it now.	 ตอนนี้ผมก็รู้สึกถึงมันได้
 He died two days later.	 เขาตายในอีกสองวันต่อมา
 A kid named Jim Nakayama out of Rigby, Idaho.	 เด็กหนุ่มชื่อ จิม นากายามะมาจากริกบี้ ไอดาโฮ
 By ten o'clock that morning, American airpower had beaten back the enemy assault.	 ตอนสิบโมงในเช้าวันนั้น กองกำลังทางอากาศของอเมริกา ตอบโต้การโจมตีของศัตรู
 The survivors from the trapped platoon were rescued that afternoon.	 ผู้มีชีวิตรอดจากกองร้อยที่ติดกับ ถูกช่วยเหลือในบ่ายนั้น
 They had been pinned to the ground and under fire for so long that they had to be coaxed into getting to their feet again.	 พวกเขาถูกตรึงกับพื้นและถูกยิงโจมตีมานาน พวกเขาถูกตรึงกับพื้นและถูกยิงโจมตีมานาน จนพวกเขาต้องถูกโน้มน้าวให้ยืนขึ้นอีกครั้ง จนพวกเขาต้องถูกโน้มน้าวให้ยืนขึ้นอีกครั้ง
 On the morning of the next day, enemy soldiers hurled themselves against the same sector of Moore's line four more times and were obliterated by artillery and machine gun fire.	 เช้าในวันถัดมา ทหารของศัตรูโจมตีใส่กลุ่มเดิม ที่เป็นแนวหน้าของมัวร์อีกสี่ครั้ง และถูกกำจัดด้วยการยิงปืนใหญ่และปืนกล
 The surviving North Vietnamese and Viet Cong withdrew into the forest, leaving behind a ghastly ring of their dead surrounding the landing zone, 634 corpses, shot, blasted, blackened by fire.	 เวียดนามเหนือและเวียดกงที่รอดชีวิต ถอนตัวเข้าป่า ทิ้งกลุ่มผู้เสียชีวิตที่น่าสยดสยอง ของพวกเขาไว้เบื้องหลัง ซึ่งอยู่รอบๆ โซนลงจอด ร่าง 634 ศพถูกยิง ระเบิด ถูกไฟเผาจนไหม้
 When I saw my soldiers dying, I felt deep sorrow for them.	 เมื่อผมเห็นทหารฝ่ายตัวเองตาย ผมโศกเศร้าให้กับพวกเขามาก
 I did't cry, I tried to hold back tears.	 ผมไม่ได้ร้องไห้ ผมพยายามกลั้นน้ำตาไว้
 We were shocked psychologically.	 เรารู้สึกสะเทือนจิตใจ
 After three days and two nights of combat, helicopters began lifting out the American survivors and gathering up the dead.	 หลังจากสามวันและสองคืนแห่งการต่อสู้ เฮลิคอปเตอร์เริ่มมารับทหารอเมริกันที่มีชีวิตรอด และรวบรวมผู้เสียชีวิต
 When you look at them, it doesn't even resemble a human body.	 เมื่อคุณมองพวกเขา มันดูไม่เหมือนร่างของมนุษย์ด้วยซ้ำ
 It just, it looks just like a mannequin.	 มันดูราวกับหุ่น
 You look at them and say, "That couldn't happen to me." I saw them fight at Ia Drang.	 คุณมองไปที่พวกเขาและพูดได้ว่า "เรื่องนั้นคงไม่เกิดกับฉัน" ผมเห็นพวกเขาต่อสู้ที่เอียดรัง
 It always galls me when I read or hear about the World War II generation as the greatest generation.	 ผมรู้สึกโกรธทุกครั้งเวลาที่ผมอ่านหรือได้ยิน... (นีล ชีแฮน) (นักหนังสือพิมพ์) (นีล ชีแฮน) (นักหนังสือพิมพ์) เรื่องคนรุ่นสงครามโลกครั้งที่สอง เป็นรุ่นที่ยอดเยี่ยมที่สุด เรื่องคนรุ่นสงครามโลกครั้งที่สอง เป็นรุ่นที่ยอดเยี่ยมที่สุด
 These kids were just as gallant and as courageous as anybody who fought in World War II.	 เด็กพวกนี้กล้าหาญและองอาจ เท่ากับบุคคลที่ต่อสู้ในสงครามโลกครั้งที่สอง
 Seventy-nine of Hal Moore's men lost their lives at Landing Zone X-Ray in the Ia Drang Valley and another 121 were wounded.	 ทหารของมัวร์เสียชีวิต 79 นาย ที่โซนลงจอดเอ็กซเรย์ในหุบเขาเอียดรัง และอีก 121 นายได้รับบาดเจ็บ
 Please convey to the American people what a tremendous fighting man we have here.	 โปรดแสดงให้ประชาชนชาวอเมริกันเห็นว่า (พันโทฮัล มัวร์) เรามีนักรบที่ยิ่งใหญ่เพียงใดอยู่ตรงนี้
 He's courageous, he's aggressive, and he's kind.	 เขาองอาจ ห้าวหาญ และอ่อนโยน
 And he'll go where you tell him to go.	 เขาจะไปในที่ที่คุณบอกให้เขาไป
 And he's got self-discipline.	 เขามีระเบียบวินัยในตัวเอง
 And he's got good unit discipline.	 และมีวินัยในหน่วยที่ดี
 He's just an outstanding man.	 เขาเป็นชายที่ยอดเยี่ยมมาก
 And...	 และ...
 Having commanded this battalion for 18 months...	 การได้บัญชาการกองพันนี้เป็นเวลา 18 เดือน
 You must excuse my emotion here, but when I see some of these men go out the way they have...	 ผมขอโทษที่แสดงอารมณ์ตรงนี้ แต่เมื่อผมเห็นคนเหล่านี้บางส่วน ออกไปในทางที่พวกเขา...
 I haven't...	 ผมไม่ได้...
 I can't tell you how highly I feel for them.	 ผมไม่สามารถบอกคุณได้ว่า ผมยกย่องพวกเขามากเพียงใด
 They're tremendous.	 พวกเขายอดเยี่ยมมาก
 Hal Moore refused to leave until every single man in his command had been accounted for.	 ฮัล มัวร์ปฏิเสธที่จะไป จนกว่าทุกคนภายใต้บัญชาการของเขา จะได้รับการช่วยเหลือ
 He had been the first of his men to step onto Landing Zone X-Ray, and he made sure he was the last to leave it.	 เขาเป็นคนแรกในกองทหารของเขา ที่ก้าวสู่โซนลงจอดเอ็กซเรย์ และเขายืนยันจะเป็นคนสุดท้ายที่จะออกมา
 The war we fought was so horribly brutal that I don't have the words to describe it.	 สงครามที่เราต่อสู้โหดร้ายมาก จนผมไม่มีคำพูดใดที่จะอธิบายได้
 I worry, how can we ever explain to the younger generation the price their parents and grandparents paid? The North Vietnamese suffered terrible losses in the Ia Drang Valley and many of the survivors were traumatized.	 ผมกังวลว่าเราจะอธิบายอย่างไร ให้กับคนรุ่นหลัง ถึงสิ่งที่พ่อแม่และปู่ย่าของพวกเขาต้องแลกมา เวียดนามเหนือพบกับความพ่ายแพ้ อย่างหนักในหุบเขาเอียดรัง และผู้รอดชีวิตหลายรายได้รับความบอบช้ำ
 "The units were enveloped in an atmosphere of gloom," a North Vietnamese colonel remembered.	 "หน่วยต่างๆ ถูกหุุ้ม ในบรรยากาศของความโศกเศร้า" ผู้พันของเวียดนามเหนือจำได้
 Some men would not leave their rope hammocks.	 บางคนไม่ยอมทิ้งเปลญวนของพวกเขา
 Some refused to wash.	 บางคนไม่ยอมซัก
 One soldier wrote a poem expressive of their plight, "The crab lies still on the chopping block Never knowing when the knife will fall." In the Ia Drang we killed ten of them for every one of us.	 ทหารนายหนึ่งเขียนกลอน ที่แสดงถึงสถานการณ์เลวร้าย "ปูนอนนิ่งบนเขียง ไม่รู้ว่ามีดจะสับลงมาเมื่อไหร่" ในเอียดรัง เราฆ่าพวกเขาสิบคนต่อเราหนึ่งคน
 That's a ten-to-one kill ratio is how the military puts that.	 เป็นอัตราส่วนการฆ่าสิบต่อหนึ่ง ที่ทหารคำนวณออกมา
 But the enemy, he was fully prepared to pay that price and more for the value of the lessons he learned.	 แต่ศัตรู พวกเขาเตรียมพร้อมเต็มที่ เพื่อที่จะรับผลของสิ่งนั้นหรือยิ่งกว่า แต่ศัตรู พวกเขาเตรียมพร้อมเต็มที่ เพื่อที่จะรับผลของสิ่งนั้นหรือยิ่งกว่า สำหรับมูลค่าของบทเรียนที่ได้เรียนรู้
 To fight the Americans, we had to get close, grab them by the belt.	 ในการต่อสู้กับทหารอเมริกัน เราต้องเข้าไปใกล้ๆ ดึงเข็มขัดของพวกเขา
 If we didn't, we couldn't fight them, and we would be killed.	 ถ้าเราไม่ทำ เราจะสู้พวกเขาไม่ได้ และเราจะถูกฆ่า
 Grab 'em by the belt buckle.	 จับหัวเข็มขัดของพวกเขา
 That means you've got to get so close, they can't use the artillery and the aerial bombardments on you for fear of killing their own.	 หมายถึงคุณต้องเข้าไปใกล้มาก จนพวกเขาไม่สามารถใช้ปืนใหญ่ หรือการระดมยิงทางอากาศใส่คุณ เพราะกลัวว่าจะฆ่าพวกเดียวกัน
 Get in so close that it's man-on-man.	 เข้าไปใกล้มากจนเป็นการสู้ตัวต่อตัว
 And then everything is even.	 แล้วทุกอย่างก็จะเสมอกัน
 The Vietnamese suffered hundreds of dead attacking Hal Moore's battalion at LZ X-Ray.	 ทหารเวียดนามต้องเสียชีวิตหลายพันนาย จากการโจมตีกองพันของฮัล มัวร์ ที่โซนลงจอดเอ็กซเรย์
 But then they ambushed another battalion a couple of days later and wiped it out.	 แต่แล้วพวกเขาซุ่มโจมตีอีกกองร้อย ในอีกสองวันต่อมาและทำลายจนสิ้นซาก แต่แล้วพวกเขาซุ่มโจมตีอีกกองร้อย ในอีกสองวันต่อมาและทำลายจนสิ้นซาก (โซนลงจอดอัลบานี โซนลงจอดเอ็กซ์เรย์)
 In the fighting near Landing Zone Albany, the enemy had gotten too close for artillery to be called in.	 ในการต่อสู้ใกล้โซนลงจอดอัลบานี ศัตรูเข้ามาใกล้เกินไปที่จะใช้ปืนใหญ่
 Out of some 425 Americans involved, 155 were killed.	 ทหารอเมริกัน 155 จาก 425 นายที่เข้าร่วมถูกฆ่า
 124 more were wounded.	 อีก 124 นายได้รับบาดเจ็บ
 Both sides claimed victory in the Ia Drang Valley.	 ทั้งสองฝ่ายอ้างชัยชนะในหุบเขาเอียดรัง (พลจัตวาริชาร์ด เค โนวส์) (ผู้ช่วยผู้บัญชาการทหารม้าที่ 1)
 The Americans talked up the number of enemy dead at Landing Zone X-Ray.	 ทหารอเมริกันพูดถึงจำนวนศัตรูที่เสียชีวิต ที่โซนลงจอดเอ็กซ์เรย์
 The ratio of losses to your kill...	 อัตราส่วนของความพ่ายแพ้ต่อการฆ่าของคุณ
 The North Vietnamese took their lessons from Landing Zone Albany.	 เวียดนามเหนือได้รับบทเรียน จากโซนลงจอดอัลบานี
 I don't anticipate that this conflict will end any time soon, and we could find that we have more difficult days ahead.	 ผมไม่ได้คาดว่า ความขัดแย้งนี้จะจบลงในเร็วๆ นี้ (นายพลวิลเลียม เวสต์มอร์แลนด์) และเราพบว่า เราจะมีวันที่ลำบากกว่าอยู่เบื้องหน้า
 Certainly we must be prepared for this.	 แน่นอนว่าเราต้องเตรียมพร้อมสำหรับเรื่องนี้
 In the fall of my senior year, November 1965, was that huge battle at the Ia Drang Valley, which was the first time there was actually confirmed North Vietnamese regular soldiers as opposed to Viet Cong.	 (จีเอขยี้กองทหารประจำการของฮานอย การต่อสู้ราคาแพงที่สุดของชาวอเมริกัน) ในฤดูใบไม้ร่วงของปีสุดท้ายของผม เดือนพฤศจิกายน 1965 การต่อสู้ครั้งใหญ่ที่หุบเขาเอียดรัง ซึ่งเป็นครั้งแรกที่มีการยืนยันอย่างจริงจังว่า ทหารประจำการของเวียดนามเหนือ แยกออกจากเวียดกง
 And of course my way of interpreting that was, "There it is, that's the proof.	 แน่นอนว่าวิธีที่ผมแปลความหมายเรื่องนั้นคือ... (บิล แอร์ฮาร์ท) (เพอร์กาซี เพนซิลเวเนีย) "นั่นไงล่ะ นั่นคือหลักฐาน
 The North Vietnamese are the aggressors here." And that's when I began thinking in terms of, maybe I don't want to go to college right away.	 เวียดนามเหนือเป็นพวกก้าวร้าว" นั่นเป็นตอนที่ผมเริ่มคิดในแง่ที่ว่า บางทีผมอาจไม่อยากไปมหาวิทยาลัยทันที
 Maybe I'll join the Marines.	 ผมจะไปร่วมกับนาวิกโยธิน
 And it was always the Marines. I never...	 และต้องเป็นนาวิกโยธิน ผมไม่เคย...
 There was no question.	 ไม่มีข้อกังขาเลย
 The Marine Corps is full of little guys like me with chips on our shoulder.	 นาวิกโยธินเต็มไปด้วยคนตัวเล็กแบบผม ที่แบกความโกรธเกลียดไว้
 The battles in the Ia Drang Valley may have been declared American victories, but privately, General Westmoreland and the Johnson administration were worried.	 การต่อสู้ในหุบเขาเอียดรัง อาจได้รับการประกาศเป็นชัยชนะของอเมริกา การต่อสู้ในหุบเขาเอียดรัง อาจได้รับการประกาศเป็นชัยชนะของอเมริกา แต่โดยส่วนตัวแล้ว นายพลเวสต์มอร์แลนด์ และฝ่ายบริหารของจอห์นสันรู้สึกกังวล
 In spite of the Americans' new airborne mobility, the enemy had been able to choose the place and time of battle.	 ทั้งที่มีความเคลื่อนไหว ของกองพลส่งทางอากาศอเมริกัน ศัตรูก็สามารถเลือก สถานที่และเวลาในการต่อสู้ได้
 The intelligence on which basic decisions had been made in Washington had been uniformly bad.	 ข่าวกรองซึ่งใช้ในการตัดสินใจขั้นพื้นฐาน ในวอชิงตันก็ไม่ดีพอๆ กัน
 There were now believed to be 12 Viet Cong regiments in South Vietnam, not just five.	 ตอนนี้เชื่อว่ามีกองทหารเวียดกง 12 กอง ในเวียดนามใต้ ไม่ใช่แค่ห้ากอง
 Nine North Vietnamese regiments, not three.	 กองทหารเวียดนามเหนือเก้ากอง ไม่ใช่สาม
 Despite months of bombing, three times as many North Vietnamese regulars were now slipping south of the demilitarized zone as originally believed.	 ทั้งที่มีการทิ้งระเบิดหลายเดือน ทหารประจำการของเวียดนามสามเท่า กำลังผ่านเข้าทางใต้ของเขตปลอดทหาร ตามที่เชื่อกันแต่แรก
 Hanoi seemed to be escalating, too.	 ฮานอยดูจะเพิ่มมากขึ้นเหมือนกัน
 And American casualties were climbing.	 ผู้ประสบภัยชาวอเมริกันก็กำลังเพิ่มขึ้น
 When Senator Fritz Hollings visited Saigon shortly after the Ia Drang battles, General Westmoreland told him, "We're killing these people at a rate of ten to one." Hollings warned him, "Westy, the American people don't care about the ten.	 เมื่อวุฒิสมาชิกฟริตซ์ ฮอลลิงส์ไปที่ไซ่ง่อน ไม่นานหลังจากการต่อสู้ที่เอียดรัง นายพลเวสต์มอร์แลนด์บอกเขาว่า "เราฆ่าคนพวกนี้ด้วยอัตราสิบต่อหนึ่ง" "เราฆ่าคนพวกนี้ด้วยอัตราสิบต่อหนึ่ง" ฮอลลิงส์เตือนเขาว่า "เวสตี้ ประชาชนชาวอเมริกัน ไม่สนใจสิบคนนั้นหรอก
 They care about the one." Westmoreland, who had said he could win the war in three years, now sent an urgent cable to Washington asking for 200,000 more troops.	 พวกเขาใส่ใจกับหนึ่งคนนั้น" เวสต์มอร์แลนด์ซึ่งบอกว่า เขาสามารถชนะสงครามได้ในสามปี เวสต์มอร์แลนด์ซึ่งบอกว่า เขาสามารถชนะสงครามได้ในสามปี ตอนนี้ส่งโทรเลขด่วนไปวอชิงตัน เพื่อขอทหารเพิ่มอีก 200,000 นาย ตอนนี้ส่งโทรเลขด่วนไปวอชิงตัน เพื่อขอทหารเพิ่มอีก 200,000 นาย
 "The message came as a shattering blow," Robert McNamara remembered.	 "ข้อความนั้นเป็นเหมือนลมแห่งความสิ้นหวัง" โรเบิร์ต แมคนามาร่าจำได้
 Once again, he offered Johnson two options, try to negotiate a compromise with Hanoi, or accede to Westmoreland's request for more men, though the chances of victory, the secretary of defense said, might be no better than one in three.	 เขาเสนอทางเลือกสองทางให้จอห์นสันอีกครั้ง พยายามเจรจาประนีประนอมกับฮานอย หรือเห็นด้วยกับคำขอ ของเวสต์มอร์แลนด์ที่ขอทหารเพิ่ม รัฐมนตรีกระทรวงกลาโหมบอกว่า แม้โอกาสที่จะชนะ อาจไม่ดีไปกว่าหนึ่งในสาม
 And then they all sat down and voted for option two.	 จากนั้นพวกเขาทุกคนนั่งลง และโหวตทางเลือกที่สอง
 My bitterness about the political powers at the time was, first of all, the lying.	 ความขมขื่นของผม เกี่ยวกับอำนาจทางการเมืองในตอนนั้น อย่างแรกเลยก็คือการโกหก (คาร์ล มาร์ลันเตส) (นาวิกโยธิน)
 I mean, I can understand a policy error that is incredibly, incredibly painful and kills a lot of people out of a mistake if they made that with noble hearts.	 คือผมสามารถเข้าใจความผิดพลาดทางนโยบาย ที่มันเจ็บปวดมากอย่างไม่น่าเชื่อ และคร่าชีวิตผู้คนมากมายเพราะความผิดพลาด หากพวกเขาทำสิ่งนั้นด้วยใจที่มีคุณธรรม
 That was, you know, when Eisenhower and Kennedy were trying to figure things out.	 นั่นเป็นตอนที่ไอเซนฮาวร์และเคนเนดี้ พยายามที่จะแก้ไขปัญหาต่างๆ
 And you read that, you know, McNamara knew by '65, it was just three years before I was there that the war was unwinnable.	 และคุณได้อ่านว่าแมคนามาร่ารู้ภายในปี 1965 เพียงสามปีก่อนที่ผมจะไปที่นั่น เขารู้ว่าสงครามนั้นไม่สามารถชนะได้
 That's what makes me mad.	 เรื่องนั้นทำให้ผมโกรธ
 Making a mistake, people can do that.	 คนเราอาจทำผิดพลาดได้
 But covering up mistakes, then you're killing people for your own ego.	 แต่การปกปิดความผิดพลาด แล้วคุณยังฆ่าผู้คนเพื่ออีโก้ของตัวเอง
 And that makes me mad.	 เรื่องนั้นทำให้ผมโมโห
 Tens of thousands of American troops continued to prepare to deploy to Vietnam from all over the country, and General Westmoreland and his commanders drew up plans for major offensives in the new year of 1966.	 ทหารอเมริกันหลายหมื่นนาย ยังคงเตรียมที่จะเคลื่อนกำลังไปเวียดนาม จากทั่วประเทศ นายพลเวสต์มอร์แลนด์และผู้บัญชาการของเขา ใช้แผนการโจมตีสำคัญในปีใหม่ในปี 1966
 Meanwhile, hoping the Soviets might help bring Hanoi to the bargaining table, McNamara urged the president to declare a halt to the bombing of North Vietnam.	 ในเวลาเดียวกันก็หวังว่าโซเวียต อาจช่วยนำฮานอย มายังโต๊ะเจรจา แมคนามาร่าขอให้ประธานาธิบดี ประกาศการยุติชั่วคราว ต่อการทิ้งระเบิดในเวียดนามเหนือ
 Over the objections of the military, who worried it would give the enemy time to rebuild its defenses, Johnson agreed to stop the bombing on Christmas Eve.	 แม้จะมีการคัดค้านของกองทัพ ที่กังวลว่าจะทำให้ศัตรูมีเวลา ในการสร้างการป้องกันขึ้นมาใหม่ จอห์นสันตกลงที่จะหยุดทิ้งระเบิด ในวันคริสต์มาสต์อีฟ
 If it achieved nothing else, he said, it would show the American people that before he committed more of their sons to battle, "We have gone the last mile." Well, Christmas always meant a great deal in our family.	 (ปฏิบัติการดาวคริสต์มาสต์) เขาบอกว่า ถ้ามันไม่บรรลุผลอย่างอื่น ก็จะแสดงให้ประชาชนชาวอเมริกันเห็นว่า ก่อนที่เขาจะให้ลูกหลานของพวกเขาเข้าร่วมต่อสู้ "เราไปถึงขั้นตอนสุดท้ายแล้ว" (สุขสันต์วันคริสต์มาสต์ แด่ทหารในเวียดนาม จากโบสถ์คริสต์แห่งแรก) คริสต์มาสต์มีความหมายอย่างมาก ในครอบครัวของเรา
 We sent packages to Denton, of course.	 แน่นอนว่าเราส่งของไปให้เดนตัน
 Then a neighbor mentioned to me that she heard a local television station was offering free tapes to be made to send to a soldier overseas.	 แล้วเพื่อนบ้านก็บอกฉันว่า เธอได้ยินสถานีโทรทัศน์ในท้องถิ่นกำลังเสนอ ที่จะทำเทปฟรีเพื่อส่งให้ทหารที่อยู่ต่างประเทศ
 We dressed up for the cameras.	 เราจึงแต่งตัวเพื่อไปออกหน้ากล้อง
 The idea was that we would each just say something about what we were doing and wish him well.	 ไอเดียคือเราแต่ละคนจะพูดอะไรบางอย่าง เกี่ยวกับสิ่งที่เราทำอยู่และอวยพรเขา
 It was a horrible day for me.	 เป็นวันที่แย่สำหรับฉัน
 It made it so real that he was far away.	 มันทำให้รู้สึกว่าเป็นเรื่องจริงที่เขาอยู่ไกลมาก
 Well, Mogie, here we are.	 โมกี้ เราอยู่นี่แล้ว
 It's... Let's see, what day is today? -Here it is, Saturday... - -November 13. -November 13, and station WTEN has given us a chance to talk to you.	 เอาล่ะ วันนี้วันอะไร นั่นแหละ วันเสาร์ - วันที่ 13 พฤศจิกายน - วันที่ 13 พฤศจิกายน และสถานีดับเบิ้ลยูทีอีเอ็น ให้โอกาสเราได้คุยกับลูก
 We all wish you a Merry Christmas, to start out with.	 เราขอเริ่มด้วยการอวยพร สุขสันต์วันคริสต์มาสต์กับลูก
 Rand, what do you got to say to Mogie? Merry Christmas.	 แรนด์ ลูกมีอะไรจะคุยกับโมกี้ไหม สุขสันต์วันคริสต์มาสต์
 Merry Christmas.	 สุขสันต์วันคริสต์มาสต์
 Merry Christmas, darling.	 สุขสันต์วันคริสต์มาสต์ลูกรัก
 We sent your packages and there's one that's waiting for you at home.	 เราส่งของไปให้ลูก และมีอย่างหนึ่งที่รอลูกอยู่ที่บ้าน
 It's a record of fife and drum music that we got for you at Williamsburg.	 ของนั้นคือแผ่นเสียงเพลงขลุ่ยและกลอง ที่เราซื้อให้ลูกที่วิลเลียมส์เบิร์ก
 Candy? My teacher isn't very nice, and she always is crabby, and I don't like school at all.	 แคนดี้จ๊ะ ครูของหนูไม่ค่อยใจดีเท่าไหร่ และเธออารมณ์เสียอยู่เสมอ หนูไม่ชอบโรงเรียนเลย
 -Now I'm a brownie. - Merry Christmas.	 ตอนนี้หนูเป็นเนตรนารีระดับสอง สุขสันต์วันคริสต์มาสต์
 Happy Christmas, Mogie.	 สุขสันต์วันคริสต์มาสต์ โมกี้
 I think I'm getting new skis for Christmas.	 ฉันคิดว่าจะซื้อสกีคู่ใหม่สำหรับวันคริสต์มาสต์
 So when you get home, we can get together sometime.	 ดังนั้นตอนเธอกลับบ้านมา เราจะได้ไปเล่นด้วยกันนะ
 We do all wish you a very Merry Christmas, and we'll be thinking of you on Christmas Day.	 เราทุกคนอวยพรให้ลูก มีความสุขมากๆ ในวันคริสต์มาสต์นะ และเราจะคิดถึงลูกในวันคริต์มาสต์
 We miss you, sweetheart.	 เราคิดถึงลูกนะ ลูกรัก
