[Jean-Marie] Well, I wanted to name him after his dad,	ฉันอยากตั้งชื่อเขาตามพ่อของเขา
Denton Winslow Crocker.	เดนตัน วินสโลว์ คร็อกเกอร์
So that was the name we chose.	นั่นเป็นชื่อที่พวกเราเลือก
He was a colicky little baby.	เขาเป็นทารกตัวน้อยร้องไห้โยเย (ฌ็อง-มารี คร็อกเกอร์) (ซาราโทกาสปริงส์ นิวยอร์ก)
And, uh, so we were up night and day with him.	(ฌ็อง-มารี คร็อกเกอร์) (ซาราโทกาสปริงส์ นิวยอร์ก) เราก็เลยตื่นมาดูแลเขาทั้งวันทั้งคืน
And my husband was a wonderful dad	สามีของฉันเป็นพ่อที่ยอดเยี่ยม
and very loving and attentive.	เขารักและเอาใจใส่มาก
He'd walk the floor with him.	เขาอุ้มลูกเดินไปเดินมา
And then he said one day, "He's a regular little mogul	แล้ววันหนึ่งเขาก็พูดว่า "เขาเป็นผู้มีอำนาจตัวน้อยที่ธรรมดา
the way he rules our lives."	เพราะเขามีอิทธิพลต่อชีวิตเรา
So that's where the name came from.	นั่นจึงเป็นที่มาของชื่อ
We called him Mogie.	เราเรียกเขาว่าโมกี้
[narrator] Mogie Crocker was born June 3, 1947, the oldest of four children.	โมกี้ คร็อกเกอร์เกิดวันที่ 3 มิถุนายน 1947 เป็นลูกคนโตในบรรดาพี่น้องสี่คน
His father was a biology teacher, and Mogie was raised in college towns.	พ่อของเขาเป็นครูสอนชีววิทยา และโมกี้ถูกเลี้ยงในเมืองของมหาวิทยาลัย
Ithaca, Amherst, and finally Saratoga Springs,	อิทากา แอมเฮิร์ส และสุดท้ายที่ซาราโทกาสปริงส์
to which the family moved in 1960, when he was 13.	ที่ครอบครัวย้ายมาในปี 1960 ตอนที่เขาอายุ 13 ปี
My mother read books to all of us.	แม่ของฉันอ่านหนังสือให้เราทุกคนฟัง (แครอล คร็อกเกอร์) (ซาราโทกาสปริงส์ นิวยอร์ก)
My brother was definitely the one	แน่นอนว่าพี่ชายของฉัน
who probably gravitated towards that more than I did.	เป็นคนที่สนใจเรื่องนั้นมากกว่าฉัน
He really feasted on books.	เขาเพลิดเพลินกับหนังสือจริงๆ
[narrator] Mogie was an unusual boy.	โมกี้เป็นเด็กที่ไม่ธรรมดา
Intelligent, independent-minded, and too nearsighted	ฉลาด มีความคิดอิสระ และสายตาสั้นมาก
to do well at team sports,	เกินกว่าที่จะเล่นกีฬาเป็นทีมได้ดี
he loved books about American history and American heroes.	เขาชอบหนังสือประวัติศาสตร์ และฮีโร่ของอเมริกา
At 12, he started a diary in which he kept track of Cold War events.	ตอนอายุ 12 ปี เขาเริ่มเขียนสมุดบันทึก ที่เขาติดตามเหตุการณ์สงครามเย็น
"I hate Reds!" he wrote,	เขาเขียนว่า "ผมเกลียดฝ่ายแดง"
and he admired most those who had proved willing	และเขาชื่นชมบุคคลที่พิสูจน์ว่ายินดี
to sacrifice themselves for a cause.	ที่จะเสียสละตัวเองเพื่อสงคราม
President John F. Kennedy's call for every American	ประธานาธิบดีจอห์น เอฟ เคนเนดี้ เรียกร้องต่อชาวอเมริกันทุกคน
to ask what he or she could do for their country	เพื่อถามถึงสิ่งที่เขาหรือเธอ อาจทำเพื่อประเทศของพวกเขาได้
had mirrored ideas he'd held since he was a small boy.	เป็นการสะท้อนถึงความคิดที่เขามี ตั้งแต่เขายังเป็นเด็กชายตัวน้อย
One evening when I was reading to Denton	ค่ำวันหนึ่งตอนที่ฉันอ่านหนังสือ ให้เดนตันฟังก่อนเข้านอน
before he went to sleep, I chose a passage from Henry V,	ค่ำวันหนึ่งตอนที่ฉันอ่านหนังสือ ให้เดนตันฟังก่อนเข้านอน ฉันเลือกบทความจากเรื่องเฮนรีที่ห้า
which is, "He today that sheds his blood with me	ซึ่งมีอยู่ว่า "เขาในวันนี้ที่ร่วมหลั่งเลือดกับข้า
shall be my brother.	จักเป็นพี่น้องข้า
And gentlemen in England now a-bed	และเหล่าสุภาพบุรุษแห่งอังกฤษทั้งหลายเอ๋ย
shall think themselves accurs'd	จงให้พวกเขาตรองด้วยตนเองเถิดว่า หากพวกเขาไม่ได้ปรากฏขึ้นที่นี่
they were not here and hold their manhood cheap	จงให้พวกเขาตรองด้วยตนเองเถิดว่า หากพวกเขาไม่ได้ปรากฏขึ้นที่นี่ แลเกียรติแห่งบุรุษของพวกเขาก็ยิ่งลดต่ำลง
while any speaks that fought with us upon St. Crispin's Day."	เมื่อได้เอ่ยแต่ละถ้อยคำออกมา ว่าพวกเขาจะต่อยุทธกับเราในวันคริสเปียน"
[Jean-Marie] I think that it was that sort of thing	ฉันคิดว่าเรื่องราวพวกนั้น
that made Denton want to be part of something important and brave.	ทำให้เดนตันอยากเป็นส่วนหนึ่ง ของเรื่องที่สำคัญและกล้าหาญ
[Lyndon Johnson] I just stayed awake last night thinking about this thing.	เมื่อคืนผมนอนไม่หลับเฝ้าคิดถึงแต่เรื่องนี้
The more I think of it, I don't know what in the hell...	(ลินดอน จอห์นสัน) (ประธานาธิบดีของสหรัฐอเมริกา) ยิ่งผมคิดถึงมัน ผมยิ่งไม่รู้ว่าทำไม...
it looks like to me we're getting into another Korea.	สำหรับผมมันดูเหมือน เราจะเข้าสู่สงครามเกาหลีอีก
It just worries the hell out of me.	มันทำให้ผมกังวลเป็นบ้าเลย
I don't see what we can ever hope to get out of there with	ผมไม่เห็นว่าเราจะหวังอะไรได้ เพื่อให้ออกมาจากที่นั่น
once we're committed.	เมื่อเราเข้าร่วมแล้ว
I don't think it's worth fighting for and I don't think we can get out.	ผมคิดว่ามันไม่คุ้มที่จะต่อสู้ และคิดว่าเราจะไม่สามารถออกมาได้
And it's just the biggest damn mess I ever saw.	และมันเป็นความยุ่งเหยิง ร้ายแรงที่สุดที่ผมเคยเห็นมาเลย
[McGeorge Bundy] It is, it's an awful mess.	มันเป็นความยุ่งเหยิงที่ร้ายแรงจริงๆ
[Johnson] I just thought about ordering those kids in there,	(แมคจอร์จ บันดี้) (ที่ปรึกษาฝ่ายความมั่นคงแห่งชาติ) ผมเคยคิดที่จะสั่งให้เด็กพวกนั้นไปที่นั่น
and what in the hell am I ordering them out there for?	แล้วทำไมผมถึงสั่งให้พวกเขาออกมาจากที่นั่นเสีย
[Bundy] One thing that has occurred to me--	สิ่งหนึ่งที่เกิดขึ้นกับผม
[Johnson speaking] What the hell is Vietnam worth to me?	เวียดนามมีค่ากับผมยังไง
What is it worth to this country?	มันมีค่ากับประเทศนี้ยังไง
[Bundy] Yeah, yeah.	ใช่ครับ ใช่
[Johnson] Now, of course, if you start running the communists,	ตอนนี้แน่นอนว่าถ้าคุณเริ่มวิ่งหนีพวกคอมมิวนิสต์
they may just chase you right into your own kitchen.	พวกเขาอาจจะวิ่งไล่ตามคุณ ไปถึงในครัวของคุณเองก็ได้
[Bundy] Yeah. That's the trouble.	ใช่ นั่นแหละปัญหา
And that is what the rest of that half of the world	และนั่นเป็นสิ่งที่พวกที่เหลือของอีกครึ่งโลก
is going to think if this thing comes apart on us.	จะคิดถ้าสิ่งนี้เกิดขึ้นกับเรา
[Johnson] It's damned easy to get in a war,	การเข้าสู่สงครามเป็นเรื่องง่ายมาก
but it's going to be awfully hard to ever extricate yourself if you get in.	แต่ถ้าเข้าร่วมไปแล้ว การเอาตัวเองออกมาจะเป็นเรื่องยากแสนเข็ญ
[Bundy] It's very easy...	มันง่ายมาก ผมอยากได้ยินวอลเตอร์ และแมคนามาราประเมินเรื่องนี้
[Bundy] To debate it?	- อภิปรายเรื่องนี้เหรอ ก็ได้ - ใช่
[Bundy] All right, what's a possible time...	เป็นเวลาที่น่าจะเกิดขึ้นได้
[narrator] Tragedy had brought Lyndon Johnson to the presidency in November of 1963.	โศกนาฏกรรมทำให้ลินดอน จอห์นสัน เป็นประธานาธิบดีในเดือนพฤศจิกายน ปี 1963
And he would not feel himself fully in charge	เขาคงไม่รู้สึกว่าตัวเองมีอำนาจเต็มที่
until he had faced the voters the following year.	จนกระทั่งเขาได้พบผู้ลงคะแนนในปีถัดมา
But his ambitions for his country were as great	แต่ความทะเยอทะยานของเขา สำหรับประเทศนี้ยิ่งใหญ่มาก
as those of his hero, Franklin Roosevelt.	เท่ากับฮีโร่ของเขา แฟรงกลิน โรสเวลต์
During his years in the White House, he would lead the struggle to win passage	ในช่วงสมัยของเขาในทำเนียบขาว เขานำการต่อสู้เพื่อชนะเส้นทาง
of more than 200 important pieces of legislation.	ไปสู่กฎหมายที่สำคัญมากกว่า 200 รายการ
The Civil Rights Act of 1964, the Voting Rights Act of 1965,	พระราชบัญญัติสิทธิพลเมืองปี 1964 พระราชบัญญัติการลงคะแนนเสียงปี 1965
federal aid to education, Head Start, Medicare,	การสนับสนุนการศึกษาของรัฐบาล โครงการการศึกษาแรกเริ่ม โครงการเมดิแคร์
and a whole series of bills aimed at ending poverty in America,	และร่างกฎหมายทั้งหมด ที่มุ่งขจัดความยากจนในอเมริกา
all intended to create what he called "The Great Society."	ทุกอย่างมุ่งที่จะสร้าง สิ่งที่เขาเรียกว่า สังคมที่ยิ่งใหญ่
In foreign affairs, Johnson was less self-assured.	ด้านการต่างประเทศ จอห์นสันไม่ค่อยมีความมั่นใจในตัวเองนัก
"Foreigners are not like the folks I'm used to,"	"ชาวต่างประเทศไม่เหมือนผู้คนที่ผมคุ้นเคย"
he once said.	เขาเคยพูดเอาไว้
To deal with them, he retained in office all of John Kennedy's top advisors.	ในการรับมือกับพวกเขา เขาเก็บที่ปรึกษา อันดับสูงของจอห์น เคนเนดี้ไว้ทั้งหมด
Dean Rusk at State,	ดีน รัสก์ กระทรวงต่างประเทศ
Robert McNamara at Defense,	โรเบิร์ต แมคนามาร่า กระทรวงกลาโหม
McGeorge Bundy as his National Security Advisor.	แมคจอร์จ บันดี้ เป็นที่ปรึกษาด้านความมั่นคงแห่งชาติ
"I need you," he told them, more than his predecessor had.	เขาบอกพวกเขาว่า "ผมต้องการพวกคุณ" มากกว่าที่ผู้อยู่ในตำแหน่งก่อนหน้าเขา
Publicly, Johnson pledged	จอห์นสันพูดต่อหน้าสาธารณชนว่า
that "This nation will keep its commitments	"ประเทศนี้จะรักษาปณิธาน
from South Vietnam to West Berlin."	จากเวียดนามใต้ไปสู่เบอร์ลินตะวันตก"
But privately, Vietnam filled him with dread.	แต่โดยส่วนตัวแล้ว เวียดนามทำให้เขากลัว
"It's going to be hell in a handbasket out there,"	"มันจะเข้าสู่สภาวะ ความสัมพันธ์ที่ย่ำแย่อย่างรวดเร็ว"
his ambassador told him.	เอกอัครราชทูตบอกเขา
"I want the South Vietnamese to get off their butts	"ผมอยากให้ชาวเวียดนามใต้ลุกขึ้นมา
and get out into those jungles	และเข้าไปในป่าพวกนั้น
and whip the hell out of some communists," the president said.	แล้วโค่นพวกคอมมิวนิสต์เสีย" ประธานาธิบดีกล่าว
"And then I want 'em to leave me alone,	"และจากนั้นผมอยากให้ พวกนั้นอย่ามายุ่งกับผม
because I've got some bigger things to do right here at home."	เพราะผมมีสิ่งอื่นที่ใหญ่กว่าต้องทำที่บ้าน"
Johnson had opposed the military coup that had overthrown	จอห์นสันคัดค้านการรัฐประหาร โดยกองทัพที่ล้มล้างอำนาจ
and murdered South Vietnamese president Ngo Dinh Diem,	และสังหารโง ดินห์ เดียม ประธานาธิบดีของเวียดนามใต้
fearing it would make a bad situation worse.	เพราะกลัวว่าจะทำให้ สถานการณ์ที่เลวร้ายแย่ลงไปอีก
It had.	ซึ่งก็จริง
The National Liberation Front, the Viet Cong,	แนวร่วมปลดปล่อยแห่งชาติหรือเวียดกง
was making coordinated attacks throughout the countryside,	ทำการโจมตีร่วมกันในชนบท
some 400 of them in just two weeks.	ถึง 400 ครั้งในเพียงสองสัปดาห์
When Diem was overthrown, we were so excited,	เมื่อเดียมถูกโค่นอำนาจ เรารู้สึกตื่นเต้นเป็นอย่างมาก
we thought we were close to liberating the whole country.	เรานึกว่าเราใกล้จะปลดปล่อย ทั้งประเทศให้เป็นอิสระได้แล้ว (เล กวน กง) (เวียดกง)
We began attacking the enemy day and night.	เราเริ่มโจมตีศัตรูทั้งกลางวันและกลางคืน
More and more puppet soldiers surrendered or defected to our side.	พลทหารรายแล้วรายเล่ายอมแพ้ หรือไม่ก็เปลี่ยนฝ่ายเข้าข้างเรา
More and more young people joined our armed forces.	คนหนุ่มสาวเข้าร่วมกองทัพของเราเพิ่มขึ้นเรื่อยๆ
[narrator] An estimated 40% of the South Vietnamese countryside,	ประมาณ 40 เปอร์เซ็นต์ ของชาวเวียดนามใต้ในชนบท
and more than 50% of the people,	และมากกว่า 50 เปอร์เซ็นต์ของประชาชน
were effectively in the hands of the Viet Cong.	อยู่ในมือของเวียดกงอย่างเต็มที่
And the Vietnamese generals who had overthrown Ngo Dinh Diem	และเหล่านายพลของเวียดนาม ที่โค่นอำนาจโง ดินห์ เดียม
were bickering among themselves.	ได้แตกคอกันเอง
The assassination of Ngo Dinh Diem set in motion	การสังหารโง ดินห์ เดียม (โรเบิร์ต โรลต์) (กองกำลังพิเศษ)
a series of coups.	เกิดขึ้นในการรัฐประหารหลายครั้ง
Each government was less effective than the one before.	รัฐบาลแต่ละชุดมีประสิทธิภาพ น้อยกว่ารัฐบาลชุดก่อน
[narrator] In January 1964, with U.S. encouragement,	ในเดือนมกราคมปี 1964 ด้วยการสนับสนุนของสหรัฐอเมริกา
General Nguyen Khanh staged yet another coup.	(นายพลเหงียน คานห์) นายพลเหงียน คานห์ ยังได้วางแผนการรัฐประหารอีก
In March, Johnson sent McNamara to Vietnam with instructions	ในเดือนมีนาคม จอห์นสันส่งแมคนามาร่า ไปเวียดนามพร้อมคำสั่งว่า
to show the people that Khanh was "our boy."	เพื่อแสดงให้ประชาชนเห็นว่า คานห์เป็นคนของเรา
[Sam Wilson] Johnson said, "Let's get him out and get him speaking to people,	จอห์นสันบอกว่า "ให้เขาออกมา และพูดต่อหน้าประชาชน
and let McNamara go with him as well	และให้แมคนามาร่าไปกับเขาด้วย
so that people can see that the United States	เพื่อให้ประชาชนเห็นว่าสหรัฐอเมริกา (แซม วิลสัน) (กองทัพบก)
is solidly behind this man."	อยู่เบื้องหลังผู้ชายคนนี้"
We fully support the people of South Vietnam.	เราสนับสนุนประชาชนของเวียดนามใต้เต็มที่
[Bui Diem speaking English] It was natural for the American to support the man on the spot.	เป็นธรรมดาที่ชาวอเมริกัน จะสนับสนุนคนที่อยู่ในตำแหน่ง
So he went along with General Khanh	ดังนั้นเขาจึงไปพร้อมกับนายพลคานห์ (บุ๋ย เดียม) (ทูตของเวียดนามใต้)
in a kind of trip somewhere in the countryside.	ในการเดินทางไปที่แห่งหนึ่งในชนบท
When Khanh gave a tedious, long, laborious speech ending up with...	ตอนที่คานห์กล่าวสุนทรพจน์ที่ยาวนาน น่าเบื่อ และใช้ความพยายามมากซึ่งจบด้วย...
"Vietnam a thousand years."	"เวียดนามหนึ่งพันปี"
McNamara leaned over to the microphone and said...	แมคนามาร่าไปที่ไมโครโฟนและพูดว่า
[Bui Diem speaking English] The American pronounce it has a different meaning in Vietnamese.	การออกเสียงของคนอเมริกัน มีความหมายอีกอย่างในภาษาเวียดนาม
What he was saying was something like, "The little duck, he wants to lie down."	สิ่งที่เขาพูดมีความหมายเหมือนว่า "เป็ดน้อย เขาต้องการจะนอน"
[Wilson] He wasn't aware of the tonal difference.	เขาไม่รู้เรื่องความแตกต่างของโทนเสียง
And McNamara grabbed one fist and held them up.	และแมคนามาร่าจับมือข้างหนึ่งและยกขึ้น
And the crowd practically disintegrated on the cobblestones.	และฝูงชนก็กระจายตัวบนพื้นก้อนหิน
[narrator] "No more of this coup shit," President Johnson told his advisors.	"ไม่เอารัฐประหารแบบนี้แล้ว" ประธานาธิบดีบอกที่ปรึกษาของเขา
But Khanh, too, lacked popular legitimacy,	แต่คานห์ก็ขาดความชอบที่นิยมเช่นกัน
and other generals continued to jockey for power.	และนายพลคนอื่นก็ยังคงคุมอำนาจต่อ
Washington turned a deaf ear to Buddhist calls	วอชิงตันเพิกเฉยต่อการเรียกร้องของชาวพุทธ
for the genuinely representative government	สำหรับรัฐบาลผู้แทนแบบดั้งเดิม ที่พวกเขาหวังว่าจะได้รับ
they'd hoped they'd get when Diem was overthrown.	สำหรับรัฐบาลผู้แทนแบบดั้งเดิม ที่พวกเขาหวังว่าจะได้รับ เมื่อเดียมถูกโค่นอำนาจ
Between January 1964 and June of 1965,	ระหว่างเดือนมกราคม ปี 1964 และมิถุนายน ปี 1965
there would be eight different governments.	น่าจะมีรัฐบาลที่แตกต่างกันแปดชุด
All of their leaders were so close to the Americans	ผู้นำทุกคนของรัฐบาลมีความใกล้ชิดกับชาวอเมริกัน
that they were seen as puppets.	และถูกมองว่าเป็นหุ่นเชิด
One weary Johnson aide suggested that the national symbol of South Vietnam	ผู้ช่วยที่เหนื่อยล้าของจอห์นสันแนะนำว่า สัญลักษณ์แห่งชาติของเวียดนามใต้
should be a turnstile.	ควรเป็นประตูหมุน
[Murray Fromson] These demonstrating students seem to symbolize	เหล่านักศึกษาที่มาประท้วง ดูเหมือนจะเป็นสัญลักษณ์
the kind of anarchy that is descending on Saigon these days.	ถึงอนาธิปไตยที่โจมตีไซ่ง่อนทุกวันนี้
This kind of political backbiting is having	การลอบกัดทางการเมืองแบบนี้
serious consequences in the countryside,	มีผลลัพธ์ที่เลวร้ายในชนบท
for until a strong government begins to function here in Saigon,	จนกระทั่งรัฐบาลที่เข้มแข็ง เริ่มจะทำหน้าที่ในไซ่ง่อน
the war against the communists will continue to founder.	สงครามต่อต้านคอมมิวนิสต์จะระส่ำระสายต่อไป
[Dong Si Nguyen speaking Vietnamese] It's very difficult to talk about Uncle Ho.	การพูดถึงลุงโฮเป็นเรื่องยากมาก
I was close to him.	ผมใกล้ชิดกับเขา
Once a senior cadre asked him,	ครั้งหนึ่งแกนนำอาวุโสถามเขาว่า
"Uncle, how come you wear rubber sandals	"ลุง ทำไมถึงใส่รองเท้าแตะยางล่ะครับ
and such simple khaki clothes?"	แล้วก็ชุดกากีธรรมดานั่นอีก"
And Ho asked him, "If your people are barefoot,	และโฮถามเขาว่า "ถ้าประชาชนของคุณเดินเท้าเปล่า
what do you do?	คุณจะทำยังไงล่ะ (ดง ซี เหงียน) (กองทัพเวียดนามเหนือ)
Who's above whom?"	ใครเหนือกว่าใคร"
[narrator] Ho Chi Minh was still a beloved figure in North Vietnam,	โฮจิมินห์ยังคงเป็นบุคคล ที่เคารพรักในเวียดนามเหนือ
still concerned that his country remained fragile,	ซึ่งยังคงกังวลว่า ประเทศของเขายังคงบอบบาง
still wary that stepping up the conflict in the South	ยังคงกังวลว่าการก้าวไปสู่ความขัดแย้งทางใต้
might force the Americans to take a still more active role.	อาจบังคับให้พวกอเมริกัน มีบทบาทในเชิงรุกมากขึ้น
But Ho now shared power with younger, more impatient leaders.	แต่โฮได้ใช้อำนาจร่วมกับ ผู้นำที่มีความอดทนมากกว่าและอายุน้อยกว่า
There had been change and turmoil in North Vietnam, too,	มีการเปลี่ยนแปลง และความโกลาหลในเวียดนามเหนือเช่นกัน
just as there had been in Saigon and Washington,	เช่นเดียวกับที่เกิดในไซ่ง่อนและวอชิงตัน
though Americans knew almost nothing about it.	แต่ชาวอเมริกันแทบจะไม่รู้อะไรเลย
[Huy Duc speaking Vietnamese] There were two factions in the North.	ในฝั่งเหนือมีการแบ่งเป็นสองฝ่าย
Although they agreed on liberating the South,	แม้พวกเขาจะเห็นด้วยกับการปลดปล่อยฝ่ายใต้
they were still debating how much violence should be used.	(ฮุย ดึ๊ก) (เวียดนามเหนือ) พวกเขายังคงโต้เถียง ว่าควรใช้ความรุนแรงมากเพียงใด
[narrator] At the Ninth Party Plenum that began in Hanoi	ในการประชุมพรรคการเมืองครั้งที่เก้า ที่เริ่มในกรุงฮานอย
on November 22, 1963,	(คณะกรรมการพรรคคอมมิวนิสต์) (ฮานอย) ในวันที่ 22 พฤศจิกายน ปี 1963
the day President Kennedy was killed in Dallas,	วันที่ประธานาธิบดีเคนเนดี้ถูกสังหารในดัลลัส
the Politburo had argued over how best to proceed in the war.	คณะกรรมการพรรคคอมมิวนิสต์ โต้เถียงเรื่องจะทำให้ดีที่สุดอย่างไรในสงคราม
North Vietnam's two communist patrons,	สองผู้อุปถัมภ์คอมมิวนิสต์ของเวียดนามเหนือ สหภาพโซเวียตและจีน
the Soviet Union and China, were giving them conflicting advice.	สองผู้อุปถัมภ์คอมมิวนิสต์ของเวียดนามเหนือ สหภาพโซเวียตและจีน กำลังให้คำแนะนำที่ขัดแย้งกัน
[Nguyen Ngoc speaking Vietnamese] We called them the two big brothers.	เราเรียกพวกเขาว่าสองพี่ใหญ่
The USSR had a new policy	สหภาพโซเวียดมีนโยบายใหม่
of de-escalating the Cold War,	ในการลดสงครามเย็น
while China urged worldwide revolution	ในขณะที่จีนเร่งให้มีการปฏิรูปทั่วโลก... (เหงียน หง็อก) (กองทัพเวียดนามเหนือ)
through violence.	ด้วยความรุนแรง
[narrator] In two weeks of sometimes bitter debate,	ในสองสัปดาห์ของการโต้แย้งที่ขัดกันในบางครั้ง
Ho Chi Minh, who favored the Soviet strategy,	โฮจิมินห์ซึ่งเห็นด้วยกับกลยุทธ์ของโซเวียต
was outmaneuvered by party First Secretary Le Duan,	ถูกเอาชนะโดยใช้อุบายโดย เล สวน เลขานุการเอกของพรรค
who sided with the Chinese.	ซึ่งอยู่ฝ่ายจีน
[Ngoc speaking Vietnamese] So when they cast their ballots,	ดังนั้นเมื่อพวกเขาให้ลงคะแนนเสียง
Ho excused himself and left the room.	โฮก็ขอตัวและออกจากห้องไป
After that,	หลังจากนั้น
Ho Chi Minh's actual power	พลังที่แท้จริงของโฮจิมินห์
was significantly diminished.	ก็หายไปอย่างเห็นได้ชัด
From then on, the person with total power,	ตั้งแต่นั้นมา คนที่มีอำนาจทั้งหมด
and who controlled the war,	และคนที่ควบคุมสงคราม
was Le Duan.	คือเล สวน
[narrator] Le Duan believed that with Diem gone, and the Saigon government in disarray,	เล สวนเชื่อว่าเมื่อเดียมไปแล้ว และรัฐบาลไซ่ง่อนอยู่ในภาวะสับสน
it was time to move quickly in 1964.	มันถึงเวลาที่จะเคลื่อนที่อย่างรวดเร็วในปี 1964
He proposed a two-phase plan for victory in South Vietnam.	เขาเสนอแผนที่มีสองระยะ เพื่อชัยชนะในเวียดนามใต้
The first phase would destroy A.R.V.N. forces	ระยะแรกจะทำลายกองกำลัง ของกองทัพบกสาธารณรัฐเวียดนาม
through big, "decisive battles".	ด้วยการต่อสู้ครั้งใหญ่และเด็ดเดี่ยว
The second, an attack on the cities, Le Duan believed,	ครั้งที่สองคือการโจมตีเมืองต่างๆ ที่เล สวนเชื่อว่า
would then set off popular revolts within them.	จะเป็นการยุติการปฏิบัติที่นิยมในเมืองเหล่านั้น
Party leaders and others suspected of having opposed the plan	ผู้นำพรรคการเมืองและคนอื่นๆ ที่ถูกสงสัยว่าคัดค้านแผน
were denounced as "revisionists," demoted,	ถูกประณามว่า "ผู้ยึดถือลัทธิใหม่" ถูกลดตำแหน่ง ไล่ออก จำคุก
dismissed, imprisoned.	ถูกลดตำแหน่ง ไล่ออก จำคุก
Hundreds were sent to "re-education camps."	หลายร้อยคนถูกส่งไปค่ายปรับความรู้ใหม่
"Uncle Ho wavers," Le Duan said, "but I have only one goal,	"ลุงโฮโลเล" เล สวนกล่าว "แต่ผมมีแค่เป้าหมายเดียว
final victory."	ชัยชนะสุดท้าย"
[woman] Secretary McNamara on line 0.	ท่านรัฐมนตรีแมคนามาร่าอยู่ในสายศูนย์
[Johnson] Bob?	- บ็อบเหรอ - ครับ ท่านประธานาธิบดี
[McNamara] Yes, Mr. President?	(ลินดอน จอห์นสัน) (ประธานาธิบดีของสหรัฐอเมริกา)
[Johnson] I hate to bother you, but...	- ขอโทษที่รบกวน แต่... - ไม่เป็นไรเลยครับ
[McNamara] No trouble at all.	(โรเบิร์ต แมคนามาร่า) (รัฐมนตรีกระทรวงกลาโหม)
[Johnson] Tell me, have we got anybody	บอกผมที เราได้คนที่มีจิตใจแบบทหาร
that's got a military mind that can give us some military plans	บอกผมที เราได้คนที่มีจิตใจแบบทหาร ที่สามารถวางแผนทางทหารให้เรา เพื่อชนะสงครามนั่นใช่ไหม
for winning that war?	ที่สามารถวางแผนทางทหารให้เรา เพื่อชนะสงครามนั่นใช่ไหม
Let's get some more of something, my friend,	ลองไปหาคนมาเพิ่มอีกสิ เพื่อน
because I'm going to have a heart attack if you don't get me something.	เพราะผมจะหัวใจวายแน่ถ้าคุณไม่หาคนมาให้
We need somebody over there that can get us some better plans than we got,	เราต้องการใครสักคนที่นั่น ที่สามารถคิดแผนที่ดีกว่าที่เรามี
because what we got is what we've had since '54.	เพราะสิ่งที่เรามี คือสิ่งที่เรามีมาตั้งแต่ปี 1954
We're not getting it done.	เราทำไม่สำเร็จสักที เรากำลังจะแพ้
We're... We're losing.	เราทำไม่สำเร็จสักที เรากำลังจะแพ้ มันเป็นเหตุผลหนึ่งที่ผมอยากกลับไป
[McNamara] Well, it's one reason I want to go back.	มันเป็นเหตุผลหนึ่งที่ผมอยากกลับไป
Kick 'em in the tail a little bit will help here at this point.	เตะหางพวกเขาสักนิด น่าจะช่วยเรื่องนี้ได้ในตอนนี้
[Johnson] Yeah.	ใช่
What I want is somebody to lay up some plans	สิ่งที่ผมต้องการ คือให้ใครบางคนคิดวางแผน
to trap these guys and whup hell out of 'em.	เพื่อวางกับดักคนพวกนี้และเฆี่ยนพวกเขา
Kill some of 'em.	ฆ่าพวกเขาเสียบ้าง
That's what I want to do.	ผมอยากทำแบบนั้น
[McNamara] I'll try and bring something back that will meet that objective.	ผมจะพยายามและเอาบางอย่างกลับมา ที่จะเป็นไปตามวัตถุประสงค์นั้น
[Johnson] Okay, Bob.	โอเค บ็อบ
[McNamara] Thank you.	ขอบคุณ
[narrator] When his counselors urged him to do so,	เมื่อที่ปรึกษาของเขาเร่งให้เขาทำเช่นนั้น
Johnson increased the number of American military personnel	จอห์นสันเพิ่มจำนวนทหารอเมริกัน
from 16,000 to more than 23,000 by the end of the year.	จาก 16,000 เป็นมากกว่า 23,000 นาย ทหารอเมริกัน 23,000 คน ในสิ้นปีนั้น
But he wanted his own team in Saigon.	แต่เขาต้องการทีมของตัวเองในไซ่ง่อน
He replaced Henry Cabot Lodge,	เขาแทนที่เฮนรี คาบ็อท ล็อดจ์
making General Maxwell Taylor his ambassador,	และตั้งนายพลแมกซ์เวล เทย์เลอร์ เป็นเอกอัครราชทูตของเขา
and selected 49-year-old General William Westmoreland,	และเลือกนายพลวิลเลียม เวสต์มอร์แลนด์ วัย 49 ปี
a decorated commander from WWII and Korea,	ผู้บัญชาการที่ติดเหรียญกล้าหาญ จากสงครามโลกครั้งที่สองและสงครามเกาหลี
to lead the American military effort.	ให้นำกองกำลังทหารของอเมริกา
The president hoped to force Hanoi to abandon its support	ประธานาธิบดีหวังจะบังคับให้ฮานอยเลิกสนับสนุน
for the guerrilla struggle in the South	การต่อสู้แบบกองโจรในตอนใต้
by gradually escalating military pressure.	โดยค่อยๆ เพิ่มแรงกดดันทางการทหาร
He authorized American pilots to bomb North Vietnamese troops	เขาอนุญาตให้นักบินของอเมริกา วางระเบิดกองทัพเวียดนามเหนือ
and installations in the neighboring country of Laos.	และค่ายทหารในลาว ซึ่งเป็นประเทศเพื่อนบ้าน (ลาว - เวียดนามเหนือ อ่าวตังเกี๋ย)
And he directed the military to oversee South Vietnamese shelling	และเขานำกองทัพทหาร เพื่อตรวจสอบการระดมยิงของเวียดนามใต้
of North Vietnamese islands and raids on coastal bases.	ในเกาะของเวียดนามเหนือ และการจู่โจมฐานทัพบนชายฝั่ง
All of it was to be conducted in secret.	ทุกอย่างจะต้องทำเป็นความลับ
The American people were not to be told.	ประชาชนชาวอเมริกันจะต้องไม่รู้
It was an election year.	ปีนั้นเป็นปีเลือกตั้ง
Meanwhile, the Joint Chiefs of Staff felt strongly	ในขณะที่คณะเสนาธิการร่วมรู้สึกอย่างรุนแรงว่า
that the United States was fighting on the enemy's terms	สหรัฐอเมริกากำลังสู้ตามเงื่อนไขของศัตรู
and urged far more drastic and dramatic action,	และเร่งให้มีการดำเนินการ ที่หนักหน่วงและรุนแรงกว่านี้
air strikes against "critical targets" in North Vietnam itself	การโจมตีทางอากาศที่เป้าหมายสำคัญ ในเวียดนามเหนือเอง
and the deployment of U.S. forces in South Vietnam,	และการเคลื่อนกำลังพล ของสหรัฐอเมริกาในเวียดนามใต้
boots on the ground.	ส่งพลทหารราบเข้าไป
Johnson refused, fearing that such aggressive moves	จอห์นสันปฏิเสธ เพราะกลัวว่าการเคลื่อนไหวที่ก้าวร้าวเช่นนั้น
would pull China into the conflict	จะดึงประเทศจีนเข้าสู่ความขัดแย้ง
just as it had entered the Korean War in 1950.	เหมือนที่เคยเข้าร่วมสงครามเกาหลีในปี 1950
[Johnson] They say get in or get out.	พวกเขาบอกให้เข้ามาหรือออกไป (ลินดอน จอห์นสัน) (ประธานาธิบดีของสหรัฐอเมริกา)
[Bundy] Yeah.	- ใช่ - และผมบอกพวกเขา
[Johnson] And I told them,	(แมคจอร์จ บันดี้) (ที่ปรึกษาฝ่ายความมั่นคงแห่งชาติ)
we haven't got any Congress that will go with us,	เราไม่ได้พาสภาคองเกรสมากับเรา
and we haven't got any mothers that will go with us	และเราไม่ได้พาแม่คนไหนมากับเราในสงคราม
in the war, and I got to win an election	และผมต้องชนะการเลือกตั้ง
and then you can make a decision.	และคุณก็สามารถตัดสินใจได้
[narrator] Polls showed him with a commanding lead over his likely Republican opponent,	โพลแสดงให้เห็นว่า เขาเป็นฝ่ายนำคู่แข่งพรรครีพับลิกัน
Senator Barry F. Goldwater of Arizona,	วุฒิสมาชิกแบร์รี เอฟ โกลด์วอเตอร์ แห่งแอริโซนา
a blunt, uncompromising critic of what he charged	นักวิจารณ์ที่ตรงไปตรงมา ไม่ออมชอม ถึงสิ่งที่เขากล่าวหา
was the administration's weakness in the face of communist aggression.	เป็นจุดอ่อนของฝ่ายบริหาร ต่อความก้าวร้าวของคอมมิวนิสต์
[Barry Goldwater] Why does he put off facing the question of what to do about Vietnam?	ทำไมเขาเลื่อนการเผชิญกับคำถาม ถึงสิ่งที่ต้องทำเกี่ยวกับเวียดนาม
Does he hope that he can wait until after the election	เขาหวังว่าจะสามารถรอจนหลังเลือกตั้งเหรอ
to confront the American public with the...	เพื่อเผชิญหน้ากับประชาชนชาวอเมริกันด้วย...
[Bill Ehrhart] Here were these communists who were overrunning Southeast Asia	ที่นี่มีพวกคอมมิวนิสต์ ที่บุกรุกเอเชียตะวันออกเฉียงใต้
and Johnson's doing nothing about it.	และจอห์นสันไม่จัดการอะไรกับเรื่องนี้
My opponent has not told you what he plans to do about the Cold War.	คู่แข่งของผมไม่ได้บอกพวกคุณว่า เขาวางแผนจะทำอะไรเกี่ยวกับสงครามเย็น
I rode around the back of a flatbed truck in Perkasie	ผมนั่งท้ายกระบะรถในเพอร์กาซี (บิล แอร์ฮาร์ต) (เพอร์กาซี เพนซิลเวเนีย)
with a bunch of my classmates singing Barry Goldwater campaign songs	พร้อมกับเพื่อนร่วมชั้นกลุ่มหนึ่ง ร้องเพลงหาเสียงของแบร์รี โกลด์วอเตอร์
because Lyndon Johnson was not tough enough	เพราะลินดอน จอห์นสันไม่เข้มแข็งพอ
on those communists.	กับพวกคอมมิวนิสต์
[narrator] Johnson felt he did not yet have the political capital	จอห์นสันรู้สึกว่าเขายังไม่มีทุนทางการเมือง
to take further action in Vietnam, but he asked his aide,	ที่จะดำเนินการต่อไปในเวียดนาม แต่เขาขอให้วิลเลียม บันดี้ ผู้ช่วยของเขา ร่างมติประชุมของสภาคองเกรส
William Bundy, to draft a congressional resolution	แต่เขาขอให้วิลเลียม บันดี้ ผู้ช่วยของเขา ร่างมติประชุมของสภาคองเกรส
authorizing him to use force if needed,	เพื่ออนุญาตให้เขาใช้กำลังได้หากจำเป็น
to be sent to Capitol Hill when the time was right.	เพื่อส่งไปยังอาคารรัฐสภา เมื่อถึงเวลาที่เหมาะสม
On July 30, 1964, South Vietnamese ships	(เวียดนามเหนือ) (อ่าวตังเกี๋ย) ในวันที่ 30 กรกฎาคม 1964 เรือเวียดนามใต้ ภายใต้คำสั่งของกองทัพสหรัฐอเมริกา
under the direction of the U.S. military	ในวันที่ 30 กรกฎาคม 1964 เรือเวียดนามใต้ ภายใต้คำสั่งของกองทัพสหรัฐอเมริกา
shelled two North Vietnamese islands in the Gulf of Tonkin.	ระดมยิงเกาะสองแห่ง ของเวียดนามเหนือในอ่าวตังเกี๋ย
The tiny North Vietnamese Navy was put on high alert.	กองทัพเรือขนาดเล็ก ของเวียดนามเหนือเฝ้าระวังสูงสุด
What followed was one of the most controversial	สิ่งที่ตามมาคือหนึ่งในเหตุการณ์ที่น่าโต้แย้งที่สุด
and consequential events in American history.	และมีผลสืบเนื่องในประวัติศาสตร์ของอเมริกา
On the afternoon of August 2,	ในตอนบ่ายของวันที่ 2 สิงหาคม เรือพิฆาตยูเอสเอสแมดด็อกซ์
the destroyer U.S.S. Maddox was moving slowly	ในตอนบ่ายของวันที่ 2 สิงหาคม เรือพิฆาตยูเอสเอสแมดด็อกซ์ เคลื่อนที่อย่างช้าๆ ผ่านน่านน้ำสากลในอ่าว
through international waters in the gulf	เคลื่อนที่อย่างช้าๆ ผ่านน่านน้ำสากลในอ่าว
on an intelligence-gathering mission in support	เพื่อทำภารกิจรวบรวมข่าวกรอง ในการสนับสนุนการดำเนินการ ของเวียดนามใต้ต่อฝ่ายเหนือ
of further South Vietnamese action against the North.	ในการสนับสนุนการดำเนินการ ของเวียดนามใต้ต่อฝ่ายเหนือ
The commander of a North Vietnamese torpedo-boat squadron	ผู้บัญชาการกองเรือรบตอร์ปิโด ของเวียดนามเหนือ
moved to attack the Maddox.	เคลื่อนที่ไปโจมตีแมดด็อกซ์
The Americans opened fire and missed.	ทหารอเมริกาเริ่มยิงแต่พลาด
North Vietnamese torpedoes also missed.	ตอร์ปิโดของเวียดนามเหนือก็พลาดเช่นกัน
But carrier-based U.S. planes damaged two of the North Vietnamese boats	แต่เครื่องบินบนเรือบรรทุกอากาศยานของสหรัฐ ทำให้เรือของเวียดนามเหนือสองลำเสียหาย
and left a third dead in the water.	และทำให้ลำที่สามจมในน่านน้ำ
Ho Chi Minh was shocked to hear of his navy's attack	โฮจิมินห์ตกใจที่ได้ยินการโจมตีทางเรือของตน
and demanded to know who had ordered it.	และต้องการรู้ว่าใครเป็นคนสั่ง
The officer on duty was officially reprimanded for impulsiveness.	เจ้าหน้าที่ที่ปฏิบัติการได้รับการตำหนิ อย่างเป็นทางการสำหรับความหุนหันพลันแล่น
No one may ever know who gave the order to attack.	ไม่มีใครรู้เลยว่าใครเป็นคนสั่งให้โจมตี
To this day, even the Vietnamese cannot agree.	จนทุกวันนี้ แม้ชาวเวียดนามจะไม่เห็นด้วย
But some believe it was Le Duan.	แต่บางคนเชื่อว่าเล สวนเป็นคนสั่ง
[Duc speaking Vietnamese] The person behind the decision	คนที่อยู่เบื้องหลังการตัดสินใจ
had to have been First Secretary Le Duan.	ต้องเป็นเเลขานุการเอก เล สวน
In 1964, Le Duan	ในปี 1964 เล สวน
wanted to elevate the war	ต้องการยกระดับสงคราม (ฮุย ดึ๊ก) (เวียดนามเหนือ)
to a new level.	ไปสู่ระดับใหม่อีกขั้น
Why would a shrewd, calculating leader	ทำไมผู้นำที่หลักแหลมและคำนวณเก่ง... (เหงียน หง็อก) (กองทัพเวียดนามเหนือ)
like Le Duan do that?	อย่างเล สวนถึงทำแบบนั้น
The countryside was in our hands.	ชนบทอยู่ในเงื้อมมือของเรา
And if the Americans hadn't intervened directly	และถ้าทหารอเมริกาไม่ได้แทรกแซงโดยตรง
with a large military force,	ด้วยกองกำลังทหารขนาดใหญ่
by 1965, perhaps,	ในปี 1965 บางที
the South Vietnamese regime would have collapsed.	ระบอบการปกครองของเวียดนามใต้ คงจะล่มสลายไปแล้ว
[narrator] Back in Washington,	ย้อนกลับไปในวอชิงตัน
the Joint Chiefs urged immediate retaliation against North Vietnam.	เสนาธิการร่วมเร่งให้มี การตอบโต้ทันทีต่อเวียดนามเหนือ
The president refused.	ประธานาธิบดีปฏิเสธ
Instead, the White House issued a warning	โดยทำเนียบขาวมีคำเตือน
about the "grave consequences" that would follow	เกี่ยวกับ "ผลตามมาที่ร้ายแรง" ซึ่งจะเกิดตามหลังสิ่งที่เรียกว่า
what it called "any further unprovoked" attacks,	เกี่ยวกับ "ผลตามมาที่ร้ายแรง" ซึ่งจะเกิดตามหลังสิ่งที่เรียกว่า การโจมตี "ที่ไร้การปลุกปั่นใดๆ"
even though Johnson knew the attack had been provoked	แม้จอห์นสันจะรู้ว่าการโจมตีถูกปลุกปั่น
by the South Vietnamese raids on North Vietnam's islands.	โดยการจู่โจมของเวียดนามใต้ บนเกาะของเวียดนามเหนือ
Both sides were playing a dangerous game.	ทั้งสองฝ่ายกำลังเล่นเกมที่อันตราย
On August 4, American radio operators mistranslated	(วันที่ 4 สิงหาคม 1964) ในวันที่ 4 สิงหาคม ผู้ปฏิบัติการทางวิทยุของอเมริกา แปลสัญญาณวิทยุของเวียดนามเหนือผิด
North Vietnamese radio traffic	แปลสัญญาณวิทยุของเวียดนามเหนือผิด
and concluded a new military operation was imminent.	และสรุปว่ามีปฏิบัติการ ทางทหารครั้งใหม่ใกล้จะเกิดขึ้น
Actually, Hanoi had simply called upon	อันที่จริงแล้ว ฮานอยเพียงเรียก ผู้บัญชาการเรือตอร์ปิโด
torpedo boat commanders to be ready for a new raid	อันที่จริงแล้ว ฮานอยเพียงเรียก ผู้บัญชาการเรือตอร์ปิโด ให้เตรียมพร้อมสำหรับการจู่โจมครั้งใหม่ โดยฝ่ายเกาหลีใต้
by the South Vietnamese.	ให้เตรียมพร้อมสำหรับการจู่โจมครั้งใหม่ โดยฝ่ายเกาหลีใต้
The Maddox and another destroyer, the Turner Joy,	แมดด็อกซ์และเทิร์นเนอร์จอย เรือพิฆาตอีกลำ
braced for a fresh attack.	เตรียมพร้อมสำหรับการโจมตีครั้งใหม่
So did the White House.	ทำเนียบขาวก็เช่นเดียวกัน
[Johnson] Go ahead, Mac.	ลงมือเลยแมค (9:43 น. เวลาฝั่งตะวันออก)
[McNamara] I-I personally would recommend to you,	ผมจะแนะนำคุณเป็นการส่วนตัวนะ (โรเบิร์ต แมคนามาร่า) (รัฐมนตรีกระทรวงกลาโหม)
after a second attack on our ships,	หลังจากการโจมตีครั้งที่สองต่อเรือของเรา
that we do retaliate against the coast of North Vietnam	เราจะทำการตอบโต้ที่ชายฝั่งของเวียดนามเหนือ
some way or other...	ด้วยทางใดทางหนึ่ง
[Johnson] What I was thinking about when I was eating breakfast,	สิ่งที่ผมคิดถึงตอนที่กำลังกินอาหารเช้า... (ลินดอน จอห์นสัน) (ประธานาธิบดีของสหรัฐอเมริกา)
when they move on us and they shoot at us,	เมื่อพวกเขามุ่งมาที่เราและยิงใส่เรา
I think we not only ought to shoot at them,	ผมคิดว่าเราไม่ควรเพียงแต่ยิงใส่พวกเขา
but almost simultaneously pull one of these things	แต่ควรจะดึงหนึ่งในสิ่งเหล่านี้ออกมาทันที
that you've been doing on one of their bridges or something.	แบบที่คุณทำกับสะพานแห่งหนึ่งของพวกเขา
[McNamara] Exactly. I quite agree with you, Mr. President.	ใช่เลย ผมเห็นด้วยเลยครับ ท่านประธานาธิบดี
[Johnson] But I wish we could have something that we've already picked out,	แต่ผมหวังว่าเราจะมีบางอย่าง ที่เราเลือกไว้อยู่แล้ว
and just hit about three of them damn quick, right after.	และโจมตีอีกสามแห่ง ที่เหลือให้เร็วหลังจากนั้นทันที
[narrator] No second attack ever happened,	ไม่มีการโจมตีครั้งที่สองเกิดขึ้น
but at the time, anxious American sonar operators	แต่ในตอนนั้น ผู้ปฏิบัติการ ด้านโซนาร์ของอเมริกาที่วิตกกังวล
aboard the Maddox and Turner Joy convinced themselves one had.	ทำให้แมดด็อกซ์และเทิร์นเนอร์จอย เชื่อว่ามีการโจมตีเกิดขึ้น
The attack was probable but not certain, Johnson was told,	จอห์นสันได้รับแจ้งว่า การโจมตีอาจเกิดขึ้นแต่ไม่แน่นอน
and since it had probably occurred,	และเนื่องจากมันอาจเกิดขึ้นได้
the president decided it should not go unanswered.	ประธานาธิบดีตัดสินใจว่า เรื่องนั้นควรได้รับการตอบกลับ
[Johnson] Aggression by terror against the peaceful villagers	ความรุนแรงโดยความหวาดกลัว ต่อชาวบ้านที่รักสงบในเวียดนามใต้
of South Vietnam has now been joined by open aggression	ความรุนแรงโดยความหวาดกลัว ต่อชาวบ้านที่รักสงบในเวียดนามใต้ ได้รับการเข้าร่วมโดยความรุนแรง ที่เริ่มขึ้นในเขตทะเลหลวง
on the high seas against the United States of America.	ได้รับการเข้าร่วมโดยความรุนแรง ที่เริ่มขึ้นในเขตทะเลหลวง ต่อสหรัฐอเมริกา
Yet our response, for the present, will be limited and fitting.	แต่การตอบโต้ของเราในขณะนี้ จะถูกจำกัดและมีความเหมาะสม
We Americans know, although others appear to forget,	พวกเราชาวอเมริกันรู้ดี แม้คนอื่นดูเหมือนจะลืม
the risk of spreading conflict.	ความเสี่ยงของการขยายความขัดแย้ง
We still seek no wider war.	เรายังคงต้องการไม่ให้สงครามขยายวงออกไป
[Everett Alvarez] If that came to be where we would be called upon	ถ้าเรื่องนั้นเกิดขึ้นในที่ที่เราจะถูกเรียกร้อง
to carry out our responsibilities,	ให้ทำตามความรับผิดชอบของเรา
and having been well-trained for this,	และการได้รับการฝึกฝนอย่างดีสำหรับเรื่องนี้ (เอเวอเรตต์ อัลวาเรซ) (นักบินของกองทัพเรือ)
I never really gave it much thought.	ผมไม่เคยคิดถึงมันอย่างจริงจัง
It was part of my duty.	มันเป็นส่วนหนึ่งของหน้าที่ผม
[narrator] Lieutenant Everett Alvarez from Salinas, California,	เรือโทเอเวอเรตต์ อัลวาเรซ จากซาลินาส แคลิฟอร์เนีย
was aboard the U.S.S. carrier Constellation.	ขึ้นเรือบรรทุกอากาศยานยูเอสเอส
His squadron of Skyhawk A-4 planes	ฝูงเครื่องบินสกายฮอว์คเอโฟร์ของเขา
was ordered to attack torpedo boat installations	ถูกสั่งให้โจมตีที่ตั้งของเรือตอร์ปิโด
and oil facilities near the port of Hon Gai.	และโรงน้ำมันใกล้ท่าเรือฮอนไก
For the first time, American pilots were going to drop bombs on North Vietnam.	เป็นครั้งแรกที่นักบินชาวอเมริกัน จะไปทิ้งระเบิดใส่เวียดนามเหนือ
[Alvarez] When we approached the target coming down from altitude,	เมื่อเราไปถึงเป้าหมายลงจากความสูง
it was obvious that they could pick us up on their radar.	เห็นได้ชัดว่าเราพวกเขาอาจพบเราได้บนเรดาร์
I remember my knees shaking.	ผมจำได้ว่าเข่าของผมสั่น
And I was saying, "Holy smokes, I'm going into war.	และผมพูดว่า "ให้ตายสิ ฉันกำลังเข้าสู่สงคราม
This is war."	นี่คือสงคราม"
I was a bit scared.	ผมรู้สึกกลัวนิดหน่อย
Once we went in and they started firing at us,	เมื่อเราเข้าไปและพวกเขาเริ่มยิงใส่เรา
the fear went away.	ความกลัวก็หายไป
Everything became smooth, deathly quiet in the cockpit.	ทุกอย่างราบรื่น เงียบสนิทในห้องขับเครื่องบิน
It was sort of like a symphony	มันเป็นเหมือนเพลงซิมโฟนี
in the sense that my plane was just like a ballet in the sky,	ในแง่ที่ว่าเครื่องบินของผม เป็นเหมือนเต้นบัลเลต์ในท้องฟ้า
and I was just performing what I was doing.	และผมกำลังแสดงสิ่งที่ผมกำลังทำ
And then I got hit.	แล้วผมก็โดนยิง
[man] Mayday, Mayday.	ขอความช่วยเหลือๆ
[narrator] Coastal militiamen captured Alvarez	นายทหารชายฝั่งจับตัวอัลวาเรซไป
and turned him over to the North Vietnamese military.	และส่งตัวเขาให้กับกองทัพเวียดนามเหนือ
[Alvarez] One fella was yelling at me in Vietnamese and saying something.	มีชายคนหนึ่งตะโกนใส่ผม เป็นภาษาเวียดนามและพูดบางอย่าง
I started talking to him in Spanish.	ผมก็เริ่มคุยกับเขาเป็นภาษาสเปน
Don't ask me why.	อย่าถามผมว่าเพราะอะไร
It seemed like a good idea at the time.	ตอนนั้นมันดูเหมือนเป็นความคิดที่ดีน่ะ
After when they discovered U.S.A. on my ID card	หลังจากนั้นเมื่อพวกเขาพบคำว่า สหรัฐอเมริกาในบัตรประจำตัวของผม (กองกำลังติดอาวุธของสหรัฐอเมริกา กองทัพเรือสหรัฐฯ ปฏิบัติการ)
and then they started speaking to me in English.	แล้วพวกเขาก็เริ่มคุยกับผมเป็นภาษาอังกฤษ
[narrator] Alvarez assumed he would be treated as a prisoner of war.	อัลวาเรซสันนิษฐานว่า เขาจะได้รับการปฏิบัติเป็นเชลยสงครม
[Alvarez] I was sticking to the code of conduct,	ผมยึดมั่นตามหลักปฏิบัติ
which is giving them name, rank, service number, and date of birth.	ซึ่งคือการบอกชื่อ ยศ หมายเลขประจำการและวันเดือนปีเกิด
But they quickly reminded me that there was no state of war,	แต่พวกเขาเตือนผมอย่างรวดเร็ว ว่าไม่มีภาวะสงคราม
no declaration of war.	ไม่มีการประกาศสงคราม
So I could not be considered a prisoner of war.	ดังนั้นผมไม่ถือว่าเป็นเชลยสงคราม
I recall thinking about it, and I says, "You know what? They're right."	ผมจำได้ว่าคิดเรื่องนั้นและพูดไปว่า "รู้อะไรไหม พวกเขาพูดถูก"
[narrator] Everett Alvarez was the first American airman	เอเวอเรตต์ อัลวาเรซ เป็นนักบินชาวอเมริกันคนแรก
to be shot out of the sky over North Vietnam,	ที่ถูกยิงร่วงจากท้องฟ้าในเวียดนามเหนือ
and the first to be imprisoned there.	และเป็นคนแรกที่ถูกจำคุกที่นั่น
Now, the president sent up to Capitol Hill	ตอนนี้ประธานาธิบดีจึงส่ง มติการประชุมไปยังอาคารรัฐสภา
the resolution he had asked his aide William Bundy to draft	ตอนนี้ประธานาธิบดีจึงส่ง มติการประชุมไปยังอาคารรัฐสภา เขาขอให้วิลเลียม บันดี้ ผู้ช่วยของเขา ร่างขึ้นมาเมื่อสองเดือนก่อน
two months earlier.	เขาขอให้วิลเลียม บันดี้ ผู้ช่วยของเขา ร่างขึ้นมาเมื่อสองเดือนก่อน
[James Willbanks] Johnson is sort of prepositioned to move anyway,	จอห์นสันเตรียมการล่วงหน้าที่จะเคลื่อนไหว
and it gives him really the incident that he needs	และทำให้เขามีเหตุการณ์ที่เขาจำเป็น
to go to Congress and ask for a resolution	ต้องไปหาสภาคองเกรสและขอมติการประชุม
that will allow him to deal with what he sees	ที่จะอนุญาตให้เขาจัดการกับสิ่งที่เขาเห็น
as aggression in Vietnam.	เป็นความรุนแรงในเวียดนาม
And what he gets is the Gulf of Tonkin Resolution,	และสิ่งที่เขาได้รับคือมติอ่าวตังเกี๋ย
which is, what he says, like "Grandma's nightshirt",	ซึ่งตามสิ่งที่เขาพูด จะเหมือนชุดนอนของคุณยาย คือมันครอบคลุมทุกอย่าง
it covers everything.	(เจมส์ วิลแบงค์ส) (ที่ปรึกษากองทัพ)
I think what Johnson is looking for is the opportunity,	ผมคิดว่าสิ่งที่จอห์นสันกำลังมองหาคือโอกาส
the right time to send a message to North Vietnam	และเวลาที่เหมาะสม ที่จะส่งข้อความไปยังเวียดนามเหนือว่า
that we're serious about supporting South Vietnam.	เราจริงจังกับการสนับสนุนเวียดนามใต้
That message is sent,	ข้อความนั้นถูกส่งไป
I think we misread the enemy	ผมคิดว่าเราอ่านศัตรูผิดไป
because they're just as serious as we are.	เพราะพวกเขาก็จริงจังเหมือนกับเรา
[narrator] On August 7, 1964,	ในวันที่ 7 สิงหาคม 1964 โดยการโหวด 88-2
by a vote of 88-2, the Senate passed	ในวันที่ 7 สิงหาคม 1964 โดยการโหวด 88-2 วุฒิสภาผ่านสิ่งที่เรียกว่ามติอ่าวตังเกี๋ย
what came to be called the Tonkin Gulf Resolution.	วุฒิสภาผ่านสิ่งที่เรียกว่ามติอ่าวตังเกี๋ย
In the House, not a single congressman opposed it.	ในสภา ไม่มีสมาชิกสภาสักคนที่จะคัดค้าน
Senator Goldwater could no longer plausibly claim	วุฒิสมาชิกโกลด์วอเตอร์ไม่อาจอ้างได้ว่า
Johnson was failing to fight back against North Vietnam,	จอห์นสันล้มเหลวในการโต้ตอบเวียดนามเหนือ
while those voters concerned that the United States was in danger	ในขณะที่ผู้โหวตเหล่านี้ก็กังวลว่า สหรัฐอเมริกาจะอยู่ในอันตราย
of becoming too deeply involved	จากการมีส่วนเกี่ยวข้องมากเกินไป
admired the president's measured response.	แต่ก็ชื่นชมการตอบสนอง ที่รอบคอบของประธานาธิบดี
Support for Johnson's handling of the war jumped overnight	แรงสนับสนุนการรับมือ ของจอห์นสันต่อสงครามเพิ่มขึ้นในข้ามคืน
from 42% to 72%.	จาก 42 เปอร์เซ็นต์เป็น 72 เปอร์เซ็นต์
The American public believed their president.	ประชาชนชาวอเมริกัน เชื่อประธานาธิบดีของพวกเขา (แอลบีเจเพื่อสหรัฐอเมริกา)
Le Duan and his comrades in Hanoi did not.	แต่เล สวนและพวกของเขาในฮานอยไม่เชื่อ
They had little faith in the president's claim	พวกเขาแทบจะไม่เชื่อ ในคำกล่าวอ้างของประธานาธิบดี
that he sought no wider war.	ที่เขาไม่ต้องการให้สงครามขยายวงกว้าง
They resolved to step up their efforts to win the struggle in the South	พวกเขาแก้ไขเพื่อเพิ่มความพยายาม ในการชนะการต่อสู้ในฝ่ายใต้
before the United States escalated its presence	ก่อนที่สหรัฐอเมริกาจะขยายการมีตัวตน
by sending in combat troops.	ด้วยการส่งกองกำลังต่อสู้
For the first time,	เป็นครั้งแรก
Hanoi began sending North Vietnamese regulars	ฮานอยเริ่มส่งทหารเวียดนามเหนือไปฝ่ายใต้
into the South, down the network of paths	ฮานอยเริ่มส่งทหารเวียดนามเหนือไปฝ่ายใต้ ตามเครือข่ายของเส้นทาง ที่พวกเขาแผ้วถางป่าของลาว
they had hacked out of the Laotian jungle,	ตามเครือข่ายของเส้นทาง ที่พวกเขาแผ้วถางป่าของลาว
the Ho Chi Minh Trail.	เส้นทางโฮจิมินห์
[Peter Kalischer] This is Bien Hoa Air Base,	นี่คือฐานทัพอากาศเบียนฮหว่า
the biggest in South Vietnam,	ใหญ่ที่สุดในเวียดนามใต้
hours after being hit by a communist mortar barrage.	หลายชั่วโมงหลังจากถูกยิง โดยการโจมตีด้วยปืนครกของคอมมิวนิสต์
[narrator] On November 1, Viet Cong guerrillas shelled	ในวันที่ 1 พฤศจิกายน กองโจรเวียดกงระดมยิงฐานทัพอากาศ ของอเมริกาที่เบียนฮหว่าใกล้ไซ่ง่อน
the American airbase at Bien Hoa near Saigon.	กองโจรเวียดกงระดมยิงฐานทัพอากาศ ของอเมริกาที่เบียนฮหว่าใกล้ไซ่ง่อน
Five Americans died.	ทหารอเมริกาเสียชีวิตห้านาย
Thirty were wounded.	บาดเจ็บสามสิบนาย
Five B-57 bombers were destroyed on the ground	เครื่องบินทิ้งระเบิดบี-57 ห้าลำถูกทำลายเป็นจุณ
and 15 more were damaged.	และเสียหายอีก 15 ลำ
[Peter Kalischer] Mr. Ambassador,	ท่านเอกอัครราชทูต
do you think this shows any new capability	ท่านคิดว่าเรื่องนี้แสดงถึงความสามารถใหม่ ที่พวกเวียดกงมีไหม
that they've got, the Viet Cong?	ท่านคิดว่าเรื่องนี้แสดงถึงความสามารถใหม่ ที่พวกเวียดกงมีไหม (แมกซ์เวล เทย์เลอร์) (เอกอัครราชทูตของสหรัฐฯ)
Uh, I would simply say they've never done this before.	ผมคงพูดแค่ว่าพวกเขาไม่เคยทำแบบนี้มาก่อน
[narrator] The Joint Chiefs advised the president to mount	เสนาธิการร่วมแนะนำให้ประธานาธิบดีเพิ่ม
an immediate all-out air attack on 94 targets in the North	การโจมตีทางอากาศทันที ใส่เป้าหมาย 94 แห่งในฝ่ายเหนือ
and to send in regular Army and Marine units,	และส่งกองทัพทหารประจำการ และหน่วยนาวิกโยธิน
not more advisors, to South Vietnam as well.	ไม่ใช่ที่ปรึกษาเพิ่มขึ้น ไปยังเวียดนามใต้เช่นกัน
He would not do it.	เขาน่าจะไม่ทำแบบนั้น
The election was just two days away.	การเลือกตั้งจะมีขึ้นในอีกแค่สองวัน
Lyndon Baines Johnson won the presidency in his own right,	ลินดอน เบนส์ จอห์นสันชนะ การเลือกตั้งประธานาธิบดีด้วยสิทธิของเขาเอง
and he won it by a landslide.	และเขาได้รับชัยชนะอย่างท่วมท้น
Within a month, the president would approve	ภายในหนึ่งเดือน ประธานาธิบดีจะอนุมัติ
what was called a "graduated response,"	สิ่งที่เรียกว่า "การตอบสนองที่มีการศึกษา"
limited air attacks on the Ho Chi Minh Trail in Laos	การโจมตีทางอากาศที่จำกัด ที่เส้นทางโฮจิมินห์ในลาว
and "tit for tat" retaliatory raids on North Vietnamese targets.	และการโจมตีตอบโต้ ต่อเป้าหมายในเวียดนามเหนือ
But he refused to undertake sustained bombing of the North	แต่เขาปฏิเสธที่จะดำเนินการ ทิ้งระเบิดสนับสนุนของฝ่ายเหนือ
until the South Vietnamese got their own house in order.	จนกว่าเวียดนามใต้จะมีสภาของตัวเองเรียบร้อย
In private, Johnson doubted that airpower alone would ever work	ในทางส่วนตัว จอห์นสันสงสัยว่า กำลังทางอากาศอย่างเดียวจะได้ผลไหม
and believed that he would eventually have to send in ground troops,	และเชื่อว่าในที่สุดเขาจะต้องส่งทหารพื้นราบไป
though he was not yet willing publicly to say so.	แม้เขายังไม่ตั้งใจจะพูดเช่นนั้นต่อสาธารณชน
[Jean-Marie] In the fall of '64, Denton was 17	ในฤดูใบไม้ร่วงปี 1964 เดนตันอายุ 17 ปี
and he was determined to go into the service.	และเขามุ่งมั่นที่จะไปรับใช้ชาติ
[narrator] Mogie Crocker had been restless since the summer.	โมกี้ คร็อกเกอร์กระสับกระส่ายมาตั้งแต่ฤดูร้อน
After the Gulf of Tonkin incident, he had confided	หลังจากเหตุการณ์ในอ่าวตังเกี๋ย เขาบอกความลับกับพี่สาวของเขาว่า เขาต้องการเข้าร่วมกับกองทัพเรือ
to his sister that he wanted to join the Navy,	เขาบอกความลับกับพี่สาวของเขาว่า เขาต้องการเข้าร่วมกับกองทัพเรือ
but he knew his parents would not sign the consent form	แต่เขารู้ว่าพ่อแม่ของเขา จะไม่ยอมเซ็นแบบฟอร์มให้ความยินยอม
that would have allowed a 17-year-old to enlist.	ที่จะอนุญาตให้บุคคลอายุ 17 ปีสมัครเป็นทหาร (ดิ แอตแลนติก) (ชาวอังกฤษที่ยิ่งใหญ่ที่สุด)
He was talking about wanting to go into the service	เขาพูดว่าเขาต้องการไปรับใช้ชาติ (แครอล คร็อกเกอร์) (ซาราโทกาสปริงส์ นิวยอร์ก)
and that his attempts to go underage had failed.	และความพยายามของเขา ที่จะไปโดยมีอายุต่ำกว่าเกณฑ์ไม่สำเร็จ
And that he wanted my parents to support him in that.	และเขาต้องการให้ พ่อแม่ของฉันสนันสนุนเขาเรื่องนั้น
[narrator] His parents tried to persuade him	พ่อแม่ของเขาพยายามโน้มน้าวเขาว่า
that he could be more useful to his country	เขาสามารถทำประโยชน์ให้กับประเทศได้มากกว่า
with a college education than as just another private.	ด้วยการศึกษาในมหาวิทยาลัย มากกว่าการไปเป็นพลทหารอีกคน
Mogie was adamant.	โมกี้มีความแน่วแน่
[Jean-Marie] Monday morning he left for school.	เช้าวันจันทร์ที่เขาออกไปเรียน
And I watched him leave.	ฉันดูเขาออกไป
But that night he didn't come in for supper	แต่คืนนั้นเขาไม่ได้กลับมากินมื้อค่ำ (ฌ็อง-มารี คร็อกเกอร์) (ซาราโทกาสปริงส์ นิวยอร์ก)
and he hadn't called.	และเขาไม่ได้โทรบอก
The day that my brother ran away has to be	วันที่น้องชายของฉันหนีไป ต้องเป็นหนึ่งในประสบการณ์ ที่แปลกประหลาดที่สุดในชีวิตฉัน
one of the most bizarre experiences in my life.	ต้องเป็นหนึ่งในประสบการณ์ ที่แปลกประหลาดที่สุดในชีวิตฉัน
I eventually happened to look in my piggy bank	ในที่สุดฉันก็ไปดูในกระปุกออมสินของฉัน
and he had taken the money I had and left a note for me.	เขาเอาเงินที่ฉันมีอยู่และทิ้งโน้ตไว้ให้ฉัน
He had promised he would pay me back.	เขาสัญญาว่าเขาจะใช้คืนให้ฉัน
[Jean-Marie] He was gone about four months	เขาไปประมาณสี่เดือน
and said that he would not come home unless we agreed to sign for him.	และบอกว่าเขาจะไม่กลับบ้าน นอกจากเราจะยอมตกลงเซ็นให้เขา
And he wouldn't be 18 until June.	และเขายังไม่ถึง 18 ปีจนกว่าจะเดือนมิถุนายน
But we did agree and he did come home.	แต่เรายอมตกลงและเขาก็กลับบ้าน
My husband felt it was an honor-bound agreement.	สามีของฉันรู้สึกว่ามันเป็นข้อตกลงที่มีเกียรติ
I was hoping that I could change his mind.	ฉันหวังว่าฉันจะสามารถเปลี่ยนใจเขาได้
[Philip Brady] To my mind, the Marine Corps represented the very best.	ในความคิดผม นาวิกโยธินยอดเยี่ยมที่สุด
And it does.	และก็เป็นเช่นนั้น
They are the best.	พวกเขายอดเยี่ยมที่สุด
And I wanted to be part of the best.	และผมอยากเป็นส่วนหนึ่งของที่สุด (ฟิลิป เบรดี้) (ที่ปรึกษาของนาวิกโยธิน)
I was competitive. I was pugnacious.	ผมชอบแข่งขันและชอบต่อสู้
But I wanted to get in the Marine Corps and go to the first war I could find.	แต่ผมอยากเข้าร่วมนาวิกโยธิน และอยากร่วมสงครามแรกที่ผมจะพบได้
[narrator] Lieutenant Philip Brady, from Port Washington, New York,	เรือโทฟิลิป เบรดี้ จากพอร์ตวอชิงตัน นิวยอร์ก
arrived in Saigon just a few days after Lyndon Johnson's election,	มาถึงไซ่ง่อนเพียงไม่กี่วัน หลังการเลือกตั้งของลินดอน จอห์นสัน
one of the new advisors sent to help shore up	หนึ่งในที่ปรึกษาใหม่ถูกส่งมาเพื่อช่วยเสริม
the South Vietnamese military.	กองทัพของเวียดนามใต้
We must ensure that women and children are not injured.	เราต้องแน่ใจว่าเด็กและสตรีจะไม่ได้รับบาดเจ็บ
[narrator] General Westmoreland himself greeted the newcomers.	นายพลเวสต์มอร์แลนด์ มาทักทายผู้มาใหม่ด้วยตนเอง
He was an impressive-looking man with an impressive record.	เขาเป็นผู้ชายที่ดูน่าประทับใจ พร้อมกับประวัติที่น่าประทับใจ
Many of the men he'd led in Tunisia, Sicily, and Normandy	ทหารหลายนายที่เขานำทัพในตูนิเซีย ซิซิลี และนอร์มังดีในช่วงสงครามโลกครั้งที่สอง
during World War II called him Superman.	ทหารหลายนายที่เขานำทัพในตูนิเซีย ซิซิลี และนอร์มังดีในช่วงสงครามโลกครั้งที่สอง เรียกเขาว่าซูเปอร์แมน
He'd fought with distinction in Korea,	เขาต่อสู้อย่างยอดเยี่ยมในเกาหลี
commanded the 101st Airborne,	บัญชาการกองพลส่งทางอากาศที่ 101
served as superintendent of West Point.	ทำหน้าที่เป็นผู้อำนวยการ โรงเรียนนายร้อยเวสต์พอยต์
TIME magazine called him	นิตยสารไทม์เรียกเขาว่า
"the sinewy personification of the American fighting man."	"แบบอย่างที่แข็งแกร่งของทหารอเมริกัน"
But at the same time, win the hearts and the minds of the people.	แต่ในเวลาเดียวกัน ก็เอาชนะใจและความคิดของประชาชน
[Brady] General Westmoreland told us that we were down	นายพลเวสต์มอร์บอกเราว่า
on the five-yard line and we just needed a few more	เราอยู่ที่เส้นห้าหลาและเราต้องการอีกนิดเดียว
to go get the touchdown.	ที่จะไปถึงเป้าหมาย
Then I went out and then I got on the ground.	ผมก็เลยออกไปและลงพื้นที่
And then I found out, "Don't you realize?	แล้วผมก็พบว่า "ไม่รู้กันเลยเหรอ
We're losing this war."	เรากำลังพ่ายแพ้ในสงครามนี้"
[narrator] Lieutenant Brady was assigned to assist Captain Frank Eller,	เรือโทเบรดี้ถูกมอบหมาย ให้ช่วยนาวาเอกแฟรงก์ เอลเลอร์
senior advisor to the 4th Battalion	ที่ปรึกษาอาวุโสของกองพันที่สี่ ของนาวิกโยธินเวียดนาม
of the Vietnamese Marine Corps, an elite unit	ที่ปรึกษาอาวุโสของกองพันที่สี่ ของนาวิกโยธินเวียดนาม หน่วยชั้นสูงที่มีสมาชิก ที่เรียกตัวเองว่า "ฉลามพิฆาต"
whose members called themselves the "Killer Sharks."	หน่วยชั้นสูงที่มีสมาชิก ที่เรียกตัวเองว่า "ฉลามพิฆาต"
You were told that you were going over there to guide,	คุณได้รับแจ้งว่าจะต้องไปที่นั่นเพื่อแนะนำ
educate, and elevate essentially	ให้ความรู้และให้กำลังใจ โดยเฉพาะอย่างยิ่ง
these "little fellas" on how to fight a war,	เหล่าทหารหนุ่มเกี่ยวกับวิธีต่อสู้ในสงคราม
when in fact, they knew exactly how to fight the war.	ที่จริงแล้ว เมื่อพวกเขารู้วิธีต่อสู้ในสงคราม
You were just an appendage.	คุณก็จะเป็นแค่ตัวประกอบ
You were there simply to guide assets that they didn't have,	คุณไปที่นั่นเพียงเพื่อแนะนำสินทรัพย์ที่พวกเขาไม่มี
American artillery, American air strikes.	ปืนใหญ่และการโจมตีทางอากาศของอเมริกา
[narrator] Brady did his best to get to know the South Vietnamese marines in his unit.	เบรดี้พยายามอย่างที่สุดเพื่อทำความรู้จัก นาวิกโยธินของเวียดนามใต้ในหน่วยของเขา
[Tran Ngoc Toan speaking English] Phil Brady come in as an assistant of the senior advisor.	ฟิล เบรดี้มาในฐานะผู้ช่วยของที่ปรึกษาอาวุโส
I said that, "You are not my advisor. You are my helper."	ผมพูดว่า "คุณไม่ใช่ที่ปรึกษา คุณเป็นผู้ช่วยของผม"
And also, "You are so tall and big.	และพูดว่า "คุณตัวสูงและใหญ่มาก
Stay away from me.	อยู่ห่างจากผมนะ
Because if you get close to me	เพราะถ้าคุณเข้าใกล้ผม
some Viet Cong sniper will shoot,	พวกมือปืนลอบยิงเวียดกงจะยิง... (ตรัน หง็อก ตวน) (นาวิกโยธินของเวียดนามใต้)
shoot at you and then they miss you	ยิงใส่คุณแล้วพวกเขาจะยิงพลาด
and then hit me."	และยิงมาโดนผม"
[narrator] Lieutenant Tran Ngoc Toan, the son of a trucker,	เรือโทตรัน หง็อก ตวน ลูกชายของคนขับรถบรรทุก
had escaped life with a hostile stepmother	หนีชีวิตที่มีแม่เลี้ยงใจร้าย
by entering the South Vietnamese Military Academy at Dalat.	ด้วยการเข้าโรงเรียนทหาร ของเวียดนามใต้ที่ด่าหลัต
He'd been fighting the Viet Cong for more than two years.	เขาต่อสู้กับเวียดกงมามากกว่าสองปี
Toan was one of the junior officers.	ตวนเป็นหนึ่งในเจ้าหน้าที่ผู้น้อย
I think he was a... I think he was a company commander.	ผมคิดว่าเขาเป็นผู้บัญชาการกองร้อย
I knew him, I liked him.	ผมรู้จักและชอบเขา
He was a Dalat graduate, which is like their West Point.	เขาเป็นผู้จบการศึกษาจากด่าหลัต ซึ่งเหมือนกับโรงเรียนนายร้อยเวสต์พอยต์
Very dedicated.	อุทิศตนเป็นอย่างมาก
[speaking English] Later we found out we understand each other more than that,	ภายหลังเราพบว่า เราเข้าใจซึ่งกันและกันมากกว่านั้น
because we are at the same generation.	เพราะเราอยู่ในรุ่นอายุเดียวกัน
[narrator] Brady, Toan, and the 4th South Vietnamese Marine Battalion	เบรดี้ ตวน และกองพันที่สี่ ของนาวิกโยธินเวียดนามใต้
were stationed near the Bien Hoa Airbase in reserve,	ประจำการใกล้กับ ฐานทัพอากาศเบียนฮหว่าเป็นกำลังเสริม
waiting to be called into action.	รอที่จะถูกเรียกให้ปฏิบัติการ
There were new rumors now,	ตอนนี้มีข่าวลือใหม่
of larger enemy units moving through the countryside.	เรื่องหน่วยขนาดใหญ่ของศัตรู กำลังเคลื่อนพลผ่านชนบท
Le Duan's plan to win a quick and decisive victory was underway.	แผนของเล สวนที่จะได้ชัยชนะ ที่เร็วและเด็ดเดียวกำลังดำเนินต่อไป
[Nguyen Van Tong speaking Vietnamese] My youngest brother's name was Nguyen Thanh Hoang.	น้องชายคนเล็กสุดของผมชื่อเหงียน ตันห์ ฮวง
He was a scout.	เขาเป็นทหารพราน
He was killed.	เขาถูกฆ่า
If you enter the cemetery, his grave is on your left.	ถ้าคุณไปที่สุสาน หลุมศพของเขาจะอยู่ทางซ้ายของคุณ (เหงียน วัน ต๋ง) (เวียดกง)
It's the sixth grave in the sixth row.	เป็นหลุมศพอันที่หกในแถวที่หก
We visit his grave one a year to remember him.	เราไปเยี่ยมหลุมศพของเขา ปีละครั้งเพื่อระลึกถึงเขา
I would like to say one more thing.	ผมอยากจะพูดอีกเรื่องหนึ่ง
My brother had a fiancee.	น้องชายของผมมีคู่หมั้น
He brought her home to meet our mother.	เขาพาเธอมาที่บ้านเพื่อพบแม่ของพวกเรา
My mother was very happy to have her as a daughter-in-law.	แม่ของผมดีใจมากที่จะได้เธอมาเป็นลูกสะใภ้
When my brother was killed,	เมื่อน้องชายของผมถูกฆ่า
she refused to marry another man,	เธอปฏิเสธที่จะแต่งงานกับชายอื่น
and took her own life instead.	เธอปฏิเสธที่จะแต่งงานกับชายอื่น และจบชีวิตของตัวเองแทน
[narrator] Nguyen Van Tong was a political officer	เหงียน วัน ต๋งเป็นเจ้าหน้าที่ทางการเมือง
in the newly created Viet Cong 9th Division,	ในหน่วยที่เก้าของเวียดกงที่เพิ่งสร้างขึ้นมาใหม่
one of perhaps 2000 Viet Cong and North Vietnamese troops	หนึ่งในกองพล 2,000 กอง ของเวียดนามเหนือและเวียดกง
who had for weeks been quietly filtering into Phuoc Tuy,	ซึ่งแทรกซึมเงียบๆ มาหลายสัปดาห์ในฟุกทุย
a supposedly "pacified" province less than 40 miles southeast of Saigon.	ที่เป็นจังหวัดซึ่งเงียบสงบทางตะวันออกเฉียงใต้ ของไซ่ง่อนน้อยกว่า 40 ไมล์
[Van Tong speaking Vietnamese] My view was, in a war,	ในสงคราม มุมมองของผมคือ
if you can't destroy the enemy's main forces,	ถ้าคุณไม่สามารถทำลายกองกำลังหลักของศัตรู
the enemy's backbone,	ที่เป็นกระดูกสันหลังของศัตรู
you can't win.	คุณก็เอาชนะไม่ได้
If we didn't destroy those forces,	ถ้าเราไม่ทำลายกองกำลังพวกนั้น
the war would last forever.	สงครามก็จะยืดเยื้ออีกนาน
[narrator] The target for Toan and his comrades	เป้าหมายสำหรับต๋งและพวกของเขา คือหมู่บ้านยุทธศาสตร์ของบินห์เจีย
was the strategic hamlet of Binh Gia,	เป้าหมายสำหรับต๋งและพวกของเขา คือหมู่บ้านยุทธศาสตร์ของบินห์เจีย (บินห์เจีย) (จังหวัดฟุกทุย)
home to some 6,000 Catholic anticommunist refugees.	ที่อยู่ของผู้ลี้ภัยต่อต้านคอมมิวนิสต์ ชาวคาทอลิกจำนวน 6,000 คน
Their plan was to seize the hamlet	แผนของพวกเขาคือการยึดหมู่บ้านนั้น
and then annihilate the forces Saigon was sure to send to retake it.	และทำลายกองกำลัง ที่ไซ่ง่อนมั่นใจว่าจะส่งไปยึดคืน
To ensure success,	เพื่อรับประกันความสำเร็จ
tons of heavy weapons were smuggled onto the coast	อาวุธหนักจำนวนมากถูกส่งไปที่ชายฝั่ง
under cover of darkness,	ซ่อนภายใต้ความมืด
mortars, machine guns, recoilless rifles capable of blasting tanks.	ปืนครก ปืนกล ปืนไรเฟิล ไร้แรงสะท้อนถอยหลังที่สามารถระเบิดรถถัง
The communists had never attempted anything on this scale before.	พวกคอมมิวนิสต์ไม่เคยพยายาม ทำสิ่งใดในระดับนี้มาก่อน
Before dawn on December 28,	ก่อนรุ่งเช้าในวันที่ 28 ธันวาคม
Viet Cong advance units easily overwhelmed the village militia	หน่วยล่วงหน้าของเวียดกง ทำลายกลุ่มติดอาวุธในหมู่บ้านได้อย่างง่ายดาย
and occupied Binh Gia.	และยึดครองบินห์เจีย
When two crack South Vietnamese Ranger companies	เมื่อกองร้อยทหารจู่โจม ของเวียดนามใต้สองหน่วย
were helicoptered in the next day,	ถูกส่งไปทางเฮลิคอปเตอร์ในวันถัดไป
they were ambushed and shot to pieces.	พวกเขาถูกซุ่มโจมตีและยิงเละเป็นชิ้นๆ
On the morning of the 30th,	ในเช้าของวันที่ 30
Philip Brady, his friend Tran Ngoc Toan,	ฟิลิป เบรดี้และตรัน หง็อก ตวนเพื่อนของเขา
and the 4th Marine Battalion were flown in to relieve	และกองพันนาวิกโยธินที่สี่บินมาเพื่อบรรเทา
and reinforce the Rangers.	และสนับสนุนทหารจู่โจม
The enemy withdrew east of the village.	ศัตรูถอนตัวจากฝั่งตะวันออกของหมู่บ้าน
[Van Tong speaking Vietnamese] Around 5 p.m. a helicopter hovered over our position,	ประมาณห้าโมงเย็น เฮลิคอปเตอร์ บินเหนือตำแหน่งของเรา
right above the regimental command post.	เหนือที่มั่นบัญชาการทางกรมทหาร
The regimental commander asked, "Can you shoot it down?"	ผู้บัญชาการกรมทหารถามว่า "คุณยิงมันให้ร่วงได้ไหม"
We said, "Yes, we can."	เราบอกว่า "ได้ครับ เราทำได้"
And a minute later	และหนึ่งนาทีต่อมา
the helicopter was hit and burst into flames.	เฮลิคอปเตอร์ถูกยิงและระเบิดเป็นไฟ
All of a sudden you could see the tracers come out	ในทันใดนั้นคุณก็เห็น กระสุนพุ่งออกมาจากทุ่งนา
of the plantation, hit the helicopter, it crashed.	กระสุนพุ่งออกมาจากทุ่งนา ยิงเฮลิคอปเตอร์จนร่วงลง
We were ordered to go down and retrieve the remains the following morning.	เราถูกสั่งให้ไปเก็บชิ้นส่วนที่เหลือในเช้าวันต่อมา
[Van Tong speaking Vietnamese] I came to the place where the helicopter crashed,	ผมมาจุดที่เฮลิคอปเตอร์ตก
and I saw four Americans, dead.	และผมเห็นทหารอเมริกันสี่นายตาย
At the time, I didn't realize	ในตอนนั้น ผมไม่ได้ตระหนักว่า
how valuable the lives of the American advisors were.	ชีวิตของที่ปรึกษาชาวอเมริกันจะมีค่าเพียงใด
The commanding officer from Saigon	เจ้าหน้าที่บัญชาการจากไซ่ง่อน... (ตรัน หง็อก ตวน) (นาวิกโยธินเวียดนามใต้)
told the battalion you have to come in and get all four	บอกกองพันว่า คุณต้องมาที่นี่และรับร่าง ของทหารอเมริกันทั้งสี่นายไป
American servicemen body.	คุณต้องมาที่นี่และรับร่าง ของทหารอเมริกันทั้งสี่นายไป
[Van Tong speaking Vietnamese] They sent an entire battalion to retrieve four American advisors.	พวกเขาส่งทั้งกองพันมา เพื่อรับที่ปรึกษาชาวอเมริกันทั้งสี่คน
[Brady] The lead company got to the remains	กองร้อยแนวหน้าไปถึงเศษซาก
and then was pounced on and mauled badly.	แล้วถูกจู่โจมและทำร้ายอย่างรุนแรง
[narrator] Twelve South Vietnamese Marines from Toan's unit were killed	นาวิกโยธินเวียดนามใต้ 12 นาย จากหน่วยของตวนถูกฆ่า
getting to the downed helicopter.	ระหว่างไปที่เฮลิคอปเตอร์ที่ตก
Their comrades wrapped them in ponchos	สหายของพวกเขาห่อร่างด้วยผ้าคลุม
and laid them out next to the dead Americans.	และวางพวกเขาไว้ข้างๆ ทหารอเมริกันที่เสียชีวิต
An American chopper dropped into the clearing.	เฮลิคอปเตอร์ของอเมริกาบินลงในที่โล่ง
The American crew jumped out under fire,	ทหารอเมริกันกระโดดลงมาภายใต้กระสุน
picked up the four Americans,	รับร่างทหารอเมริกันทั้งสี่นาย
climbed back into their chopper, and took off again.	ปีนกลับขึ้นเฮลิคอปเตอร์และบินขึ้นอีกครั้ง
[Ngoc Toan speaking English] And we told them, "Hey, try to get all my body out of here too."	และเราบอกพวกเขาว่า "เฮ้ มารับทั้งร่างของฉันไปจากที่นี่ด้วย"
But they refuse to pick up our body.	แต่พวกเขาปฏิเสธที่จะรับร่างของพวกเรา
[narrator] For three hours,	เป็นเวลาสามชั่วโมง
Toan and his men stayed with their own dead	ตวนและคนของเขาอยู่กับผู้เสียชีวิต
waiting for a helicopter to carry them off the battlefield.	รอให้เฮลิคอปเตอร์มารับพวกเขาไปจากสนามรบ
[Brady] Meanwhile, I am getting a little bit antsy	ในระหว่างนั้น ผมเริ่มรู้สึกกังวลเล็กน้อย
because, first of all, we're losing light.	เพราะว่าอย่างแรกคือเราจะไม่มีแสงสว่าง
Second of all, we are now outside of artillery range.	อย่างที่สองคือตอนนี้เราอยู่นอกระยะปืนใหญ่
We've got to get out of there.	เราต้องออกไปจากที่นี่
[Ngoc Toan in English] We have to move out of here	เราต้องย้ายออกจากที่นี่
because they coming.	เพราะพวกมันกำลังมา
And we don't have time.	และเราไม่มีเวลาแล้ว
[Brady] I went to the Major Nho, his name was, and I said,	ผมไปหาพันตรีโนห์ ชื่อของเขาตอนนั้น และผมก็พูดว่า
"Major, we have to get out of here now."	"พันตรี เราต้องออกไปจากที่นี่เดี๋ยวนี้"
And Nho said, "Don't you forget I am a major,	และโนห์พูดว่า "อย่าลืมนะว่าผมเป็นพันตรี
and you are a lieutenant,"	และคุณเป็นร้อยโท"
turned on his heel and walked away.	เขาหันหลังกลับและเดินจากไป
Ten minutes later all hell broke loose.	สิบนาทีต่อมาก็เกิดความอลหม่านขึ้น
[Ngoc Toan speaking English] They start shelling.	พวกเขาเริ่มระดมยิง
They start shelling into our bodies.	พวกเขาเริ่มระดมยิงใส่ร่างของพวกเรา
That's the first time in the war of Vietnam	นั่นเป็นครั้งแรกในสงครามเวียดนาม
they start shelling before they attack.	พวกเขาเริ่มระดมยิงก่อนที่จะโจมตี
[narrator] The shelling eventually died down.	ในที่สุดการระดมยิงค่อยๆ ยุติลง
But then bugles blew,	แต่แล้วก็มีแตรทหารดังขึ้น
and wave after wave of enemy troops advanced toward the badly outnumbered men.	และกองทัพศัตรูคลื่นแล้วคลื่นเล่า มุ่งหน้ามาที่ทหารที่มีจำนวนมากกว่าเยอะ
[Brady] It was as if you turned a soundtrack of shooting...	ราวกับว่าคุณเป็นเพลงประกอบเป็นเสียงปืน
It just went... [imitates rapid gunfire]	เสียงแบบว่า...
Just like that. All of a sudden it came out of nowhere.	แบบนั้นเลย ในทันใดนั้นมันมาจากไหนไม่รู้
We used what little air strikes we had left with helicopters,	เราใช้การโจมตีทางอากาศนิดหน่อย และเราก็ออกมาด้วยเฮลิคอปเตอร์
calling in the strikes on our position to slow it down.	เรียกให้มีการโจมตีในตำแหน่งของเรา เพื่อทำให้มันช้าลง
There was no way.	ไม่มีทางอื่นแล้ว
[Ngoc Toan speaking English] We were surrounded and they keep coming.	เราถูกล้อมและพวกมันก็มาเรื่อยๆ
I was shot.	ผมถูกยิง
The first shot, right here.	นัดแรกตรงนี้
And then,	จากนั้น
the second shot was right here.	นัดที่สองเข้าตรงนี้
The AK-47 put through right here,	ปืนเอเค-47 ยิงเข้าตรงนี้
make a big hole like this.	ทำให้เกิดรูใหญ่แบบนี้
But I still keep fighting.	แต่ผมยังสู้ต่อไป
I don't feel any pain at all.	ผมไม่รู้สึกเจ็บสักนิด
I don't have time to think about it.	ผมไม่มีเวลาคิดถึงมัน
[Brady] What we did was we tried to get out.	สิ่งที่เราทำคือเราพยายามจะออกมา
Twenty-six of us broke through.	พวกเรา 26 นายฝ่าไป
Eleven ultimately made it.	ท้ายที่สุดมี 11 นายที่รอดชีวิตมาได้
[gunfire] [narrator] All that night, the Viet Cong moved among the trees,	คืนนั้นทั้งคืน เวียดกงเดินทางท่ามกลางต้นไม้
carrying away their wounded	อุ้มร่างผู้บาดเจ็บของพวกเขา
and shooting any South Vietnamese troops they found alive.	และยิงใส่กองทหารเวียดนามใต้ ที่พวกเขาพบว่ายังมีชีวิตอยู่
[Ngoc Toan speaking English] I played dead.	ผมแกล้งตาย
And the Viet Cong come in and they kick my body.	พวกเวียดกงเข้ามาและเตะร่างของผม
[gunshots] One bullet will get through right here.	กระสุนนัดหนึ่งจะยิงผ่านตรงนี้
And suddenly I feel,	และทันใดนั้นผมก็รู้สึก
oh, I'm still alive.	โอ้ ผมยังมีชีวิตอยู่
No problem.	ไม่มีปัญหา
So I just play, still playing dead.	ผมก็เลยแค่แกล้งตาย
And then they move back and they withdraw.	และเมื่อพวกเขาถอยไปและถอนกำลัง
[narrator] Cradling his rifle in his arms,	ตวนถือปืนไรเฟิลในมือ
Toan began trying to crawl toward Binh Gia.	เขาเริ่มพยายามคลานกลับไปบินห์เจีย
He was not found for three days.	ไม่มีคนพบเขาเป็นเวลาสามวัน
[Ngoc Toan speaking English] And one of the paratroop, he come to pick me up, and he said.	และหนึ่งในกองทหารพลร่มมารับผมและพูดว่า
"Oh it's horrible. He smell horrible.	"โอ้ แย่ชะมัด เขากลิ่นแรงมาก
Like a dead rat."	อย่างกับหนูตาย"
And I look back at all the worms and ants around my wounds.	ผมก็มองไปที่หนอนกับมดที่อยู่รอบแผลของผม
By that time, I have time to feel pain.	ในตอนนั้น ผมมีเวลาที่จะรู้สึกเจ็บแล้ว
Because all three days I'm trying to survive.	เพราะตลอดสามวันผมพยายามที่จะมีชีวิตรอด
[narrator] When it was all over,	เมื่อทุกอย่างจบลง
five Americans had died at Binh Gia.	ทหารอเมริกันห้านายตายที่บินห์เจีย
Thirty-two Viet Cong bodies had been left on the battlefield.	ร่างของพวกเวียดกง 32 ศพถูกทิ้งไว้ในสนามรบ
Two hundred South Vietnamese were killed,	ชาวเวียดนามใต้ 200 คนถูกฆ่า
200 more were wounded.	อีกกว่า 200 คนได้รับบาดเจ็บ
[Van Tong speaking Vietnamese] I'll never forget those sights.	ผมจะไม่มีวันลืมภาพเหล่านั้นเลย
Everywhere we went,	ทุกที่ที่เราไป
we saw corpses of the Saigon soldiers.	เราเห็นศพของทหารไซ่ง่อน
[Brady] What it really said was	สิ่งที่พูดกันจริงๆ ก็คือ
they were capable of marshaling this kind of force.	พวกเขาสามารถระดมกำลังแบบนี้ได้
The Vietnamese officers I talked to in the Marine Corps	เจ้าหน้าที่เวียดนาม ที่ผมคุยด้วยในหน่วยนาวิกโยธิน
figured they had six months before the end.	พบว่าพวกเขามีเวลาหกเดือนก่อนที่จะสิ้นสุด
[narrator] The big question after Binh Gia,	"คำถามสำคัญหลังจากบินห์เจีย"
an American officer at headquarters said,	เจ้าหน้าที่ชาวอเมริกันที่กองบัญชาการพูดว่า
"is how a thousand or more enemy troops	"คือกองทัพศัตรูมากกว่าพันคน
could wander around the countryside so close to Saigon	มาเดินรอบๆ ชนบทที่ใกล้มากกับไซ่ง่อน
without being discovered.	โดยไม่ถูกพบได้อย่างไร
That tells you something about this war."	เรื่องนั้นบอกให้คุณรู้บางอย่างเกี่ยวกับสงครามนี้"
Hanoi was exultant.	ฮานอยดีอกดีใจมาก
Ho Chi Minh called it "a little Dien Bien Phu."	โฮจิมินห์เรียกมันว่า "เดียนเบียนฟูน้อย"
Le Duan was convinced his strategy was working.	เล สวนเชื่อว่ากลยุทธ์ของเขาได้ผล
"The liberation war of South Vietnam has progressed	"สงครามการปลดปล่อยเวียดนามใต้คืบหน้า
by leaps and bounds," he said.	ด้วยการกระโจนและกระโดด" เขากล่าว
"After the battle of Ap Bac two years ago,	"หลังจากการต่อสู้ในอั๊บบั๊กเมื่อสองปีก่อน
the enemy knew it would be difficult to defeat us.	ศัตรูรู้ว่าการเอาชนะเราเป็นเรื่องยาก
After Binh Gia, the enemy realizes	หลังจากบินห์เจีย ศัตรูตระหนักว่า
that he is in the process of being defeated by us."	พวกเขาอยู่ระหว่างการถูกพวกเราโค่นลง"
[Van Tong speaking Vietnamese] I believe the battle at Binh Gia was historic milestone in the war.	ผมเชื่อว่าการต่อสู้ที่บินห์เจีย เป็นเหตุการณ์ประวัติศาสตร์ในสงคราม
If the Americans hadn't gotten involved,	ถ้าทหารอเมริกันไม่ได้เข้ามาเกี่ยวข้อง
we would have entered Saigon in 1966.	เราคงเข้าไปในไซ่ง่อนในปี 1966
[Johnson] I, Lyndon Baines Johnson,	ผม ลินดอน เบนส์ จอห์นสัน ขอสาบานอย่างจริงจังว่า
do solemnly swear...	ผม ลินดอน เบนส์ จอห์นสัน ขอสาบานอย่างจริงจังว่า (วันที่ 20 มกราคม 1965)
[narrator] Twenty-six days after the Binh Gia battle ended	หลังจากการต่อสู้ที่บินห์เจียยุติลง 26 วัน
and just a week after President Johnson's inauguration,	และเพียงหนึ่งสัปดาห์หลังจากพิธีเข้ารับตำแหน่ง ของประธานาธิบดีจอห์นสัน
McGeorge Bundy handed the president a memorandum.	แมคจอร์จ บันดี้ยื่นบันทึกให้ประธานาธิบดี
I will to the best of my ability.	ผมจะใช้ความสามารถของผมให้เต็มที่
[narrator] The current strategy was clearly not working, it said.	บันทึกกล่าวว่า เห็นได้ชัดกลยุทธ์ปัจจุบันไม่ได้ผล
The Viet Cong were on the move and on the rise,	พวกเวียดกงเป็นฝ่ายรุกและได้เปรียบ
supplied and now steadily reinforced with soldiers from North Vietnam.	ได้รับสิ่งของและตอนนี้ได้รับการสนับสนุน อย่างมั่นคงด้วยทหารจากเวียดนามเหนือ
If an independent South Vietnam was to survive,	หากเวียดนามใต้ที่เป็นเอกราชจะรอดได้
the United States needed to act fast.	สหรัฐอเมริกาจะต้องดำเนินการโดยเร็ว
The administration faced two choices, Bundy said.	ฝ่ายบริหารมีทางเลือกสองทาง บันดี้กล่าว
It could go along as it had been going	อาจจะทำตามที่เคยทำมาก่อน
and try to negotiate some kind of face-saving settlement.	และพยายามเจรจาข้อตกลงที่รักษาหน้า
Or they could use still more American military power	หรือพวกเขาอาจใช้กำลังทางทหารอเมริกันมากขึ้น
to force the North to abandon its goal of uniting the country.	เพื่อบังคับให้ฝ่ายเหนือ ละทิ้งเป้าหมายในการรวมประเทศ
Bundy and McNamara favored that option.	บันดี้และแมคนามาร่าเห็นด้วยกับทางเลือกนั้น
Unless the president chose it, they said, South Vietnam would fall.	พวกเขากล่าวว่า ถ้าประธานาธิบดี ไม่เลือกทางนั้น เวียดนามใต้ก็จะล่มสลาย
"I don't think anything," Johnson told McNamara,	จอห์นสันบอกแมคนามาร่าว่า "ผมไม่คิดว่าอะไร
"is going to be as bad as losing."	จะแย่เท่ากับการพ่ายแพ้"
Then, a little over a week later,	จากนั้น เกินหนึ่งสัปดาห์เล็กน้อยต่อมา
guerrillas struck an American helicopter base at Pleiku	กองโจรโจมตีฐานทัพ เฮลิคอปเตอร์ของอเมริกาที่เปลคู
in the Central Highlands,	ในที่ราบสูงภาคกลาง
killing eight American advisors and wounding over 100 more.	สังหารที่ปรึกษาชาวอเมริกันแปดคน และบาดเจ็บมากกว่า 100 คน
[McNamara] Approximately 24 hours ago,	ประมาณ 24 ชั่วโมงที่แล้ว
the first attack in the Pleiku area...	การโจมตีครั้งแรกในบริเวณเปลคู
[narrator] Johnson immediately approved an air strike on a North Vietnamese army barracks.	จอห์นสันอนุมัติการโจมตีทางอากาศทันที ต่อค่ายทหารกองทัพเวียดนามเหนือ
On February 10, 1965, the Viet Cong blew up a hotel in Qui Nhon,	ในวันที่ 10 กุมภาพันธ์ 1965 เวียดกงระเบิดโรงแรมในควิโนห์
killing 23 Americans and pinning 21 more beneath the rubble.	สังหารชาวอเมริกัน 23 คน และฝังร่างอีก 21 คนไว้ใต้เศษปูน
Johnson ordered another airstrike.	จอห์นสันสั่งการโจมตีทางอากาศอีก
Anxiety about what seemed to be happening spread around the world.	ความวิตกกังวลเกี่ยวกับ สิ่งที่กำลังเกิดขึ้นแพร่ขยายไปทั่วโลก
France, which had spent nearly a century in Vietnam,	ฝรั่งเศสที่ใช้เวลาเกือบหนึ่งศตวรรษในเวียดนาม
now called for an end to all foreign involvement there.	เรียกร้องให้ยุติ ความเกี่ยวข้องด้านต่างประเทศที่นั่นทั้งหมด
The British prime minister urged restraint.	นายกรัฐมนตรีของอังกฤษขอให้มีการยับยั้ง
Many leaders of the president's own party agreed,	ผู้นำหลายคนในพรรค ของประธานาธิบดีเองก็เห็นด้วย
though not in public.	แม้ไม่ใช่ต่อสาธารณะ
In a private memorandum,	ในบันทึกส่วนตัว
Johnson's own vice president, Hubert Humphrey,	ฮิวเบิร์ต ฮัมฟรีย์ รองประธานาธิบดีของจอห์นสัน
warned him that widening the war would undercut	เตือนเขาว่าการขยายสงคราม จะลดอำนาจของสังคมที่ยิ่งใหญ่
the Great Society, damage America's image overseas,	เตือนเขาว่าการขยายสงคราม จะลดอำนาจของสังคมที่ยิ่งใหญ่ ทำลายภาพพจน์ของอเมริกาในต่างประเทศ
and end any hope of improving relations with the Soviet Union.	และยุติความหวังในการทำให้ ความสัมพันธ์กับสหภาพโซเวียตดีขึ้น
Johnson never responded.	จอห์นสันไม่ได้ตอบกลับไป
Instead, on March 2, 1965,	แต่ในวันที่ 2 มีนาคม 1965
the United States began a systematic bombardment of targets in North Vietnam,	สหรัฐอเมริกาเริ่มการโจมตีเป็นระบบ ต่อเป้าหมายในเวียดนามเหนือ
code-named Operation Rolling Thunder.	โดยมีชื่อรหัสว่า ปฏิบัติการสายฟ้าฟาด ปฏิบัติการสายฟ้าฟาด
It was meant to be a "mounting crescendo" of air raids,	มันเป็นการค่อยๆ เพิ่มขึ้น ของการโจมตีทางอากาศ
Ambassador Taylor wrote,	เอกอัครราชทูตเทย์เลอร์เขียนไว้
intended to bolster morale in the South	มุ่งที่จะสนับสนุนกำลังใจในฝ่ายใต้ และทำลายกำลังใจในฝ่ายเหนือ
and destroy morale in the North.	มุ่งที่จะสนับสนุนกำลังใจในฝ่ายใต้ และทำลายกำลังใจในฝ่ายเหนือ (ตันห์ ฮวา - วินห์ - เวียดนามเหนือ ดองฮอย - ดีเอ็มซี)
[Wilson] The thesis behind Rolling Thunder,	แนวคิดเบื้องหลังกลยุทธ์สายฟ้าฟาด
as I understood it, was that as we ratcheted up the tempo	ตามที่ผมเข้าใจคือเป็นการที่เราเร่งจังหวะ
and the volume of this effort against the North Vietnamese,	และปริมาณของความพยายามนี้ ต่อเวียดนามเหนือ
sooner or later they would cry uncle.	ไม่ช้าก็เร็วพวกเขาก็จะยอมแพ้
And there'd be a pause,	และจะมีการหยุดพัก
and we would begin to negotiate our way out of this situation.	(แซม วิลสัน) (กองทัพ) และเราจะเริ่มเจรจา ด้วยวิธีของเราต่อสถานการณ์นี้
This became an article of faith.	นี่กลายเป็นบทความแห่งความเชื่อมั่น
And this article of faith was a fallacious assumption.	และบทความแห่งความเชื่อมั่นนี้ เป็นข้อสันนิษฐานที่ผิดพลาด
They weren't going to give up.	พวกเขาจะไม่ยอมแพ้
They read us better than we read them.	พวกเขาอ่านเราได้ดีกว่าที่เราอ่านพวกเขา
[narrator] The president insisted on strict secrecy,	ประธานาธิบดียืนกราน ให้เก็บเป็นความลับอย่างเคร่งครัด
the American people were not to be told	ประชาชนชาวอเมริกันต้องไม่ได้รับรู้ว่า
that the administration had changed its policy	ฝ่ายบริหารเปลี่ยนนโยบาย
from retaliatory airstrikes to systematic bombing,	จากการโจมตีทางอากาศเพื่อตอบโต้ เป็นการทิ้งระเบิดเป็นระบบ
that he had, in fact, widened the war.	และอันที่จริงแล้วเขาขยายวงสงคราม
They jointly agreed that joint retaliatory action was required.	พวกเขาเห็นด้วยร่วมกันว่า จำเป็นต้องมีการตอบโต้ร่วมกัน
[narrator] General Westmoreland, who had initially been hesitant	นายพลเวสต์มอร์แลนด์ที่ลังเลในตอนแรก
about committing ground troops to Vietnam,	เกี่วกับการส่งกองทหารราบไปยังเวียดนาม
now asked for two battalions of Marines, 3,500 men,	ตอนนี้ขอกองทัพนาวิกโยธินสองกอง 3,500 นาย
to protect the Danang airbase	เพื่อปกป้องฐานทัพอากาศดานัง
from which fighter-bombers were hitting the North.	ที่เครื่องบินขับไล่ทิ้งระเบิดกำลังโจมตีฝ่ายเหนือ
Ambassador Taylor, who had once called for ground troops,	เอกอัครราชทูตเทย์เลอร์ ซึ่งเคยเรียกร้องกองทหารราบ
now objected to the whole idea.	ตอนนี้คัดค้านความคิดทั้งหมด
"Once you put that first soldier ashore," he wrote,	เขาเขียนว่า "เมื่อคุณให้ทหารนายแรกขึ้นบก
"you never know how many others are going to follow him."	คุณจะไม่รู้เลยว่ามีอีกกี่คนที่จะตามเขามา"
But the president felt he had no choice but to give Westmoreland	แต่ประธานาธิบดีรู้สึกว่าเขาไม่มีทางเลือก นอกจากให้ในสิ่งที่เวสต์มอร์แลนด์ร้องขอ
what he asked for.	นอกจากให้ในสิ่งที่เวสต์มอร์แลนด์ร้องขอ
He knew he would be blamed if more American advisors died.	เขารู้ว่าจะถูกกล่าวโทษ ถ้าที่ปรึกษาชาวอเมริกันตายเพิ่มอีก
"I feel like a jackass caught in a Texas hailstorm,"	"ผมรู้สึกเหมือนคนโง่ติดในพายุลูกเห็บในเท็กซัส"
he complained.	เขาตัดพ้อ
"I can't run, I can't hide, and I can't make it stop."	"ผมวิ่งหนีไม่ได้ ซ่อนไม่ได้ และผมก็ทำให้มันหยุดไม่ได้"
In March of 1965,	ในเดือนมีนาคม ปี 1965
Johnson finally took the action he had managed to avoid for so long.	ในที่สุดจอห์นสันมีการดำเนินการ ที่เขาเคยหลีกเลี่ยงมานาน
[narrator] He was putting American ground troops in Vietnam.	เขาส่งกองทหารราบอเมริกันไปในเวียดนาม
[narrator] The government of South Vietnam was not even consulted.	ไม่มีแม้แต่การปรึกษากับรัฐบาลของเวียดนามใต้
The United States of America had larger considerations.	สหรัฐอเมริกามีสิ่งตอบแทนที่มีค่ามากกว่า
[Gard] Clearly, we saw it in terms of the Cold War.	เห็นได้ชัดว่าเราเห็นมัน ในรูปแบบของสงครามเย็น
Assistant Secretary of Defense John McNaughton said...	ผู้ช่วยรัฐมนตรีกระทรวงกลาโหม จอห์น แมคนอตันพูดว่า
He said our interests there	เขาบอกว่าผลประโยชน์ของเราที่นั่น เจ็ดสิบเปอร์เซ็นต์คือการหลีกเลี่ยงความเสียหน้า
were 70% to avoid humiliation,	เขาบอกว่าผลประโยชน์ของเราที่นั่น เจ็ดสิบเปอร์เซ็นต์คือการหลีกเลี่ยงความเสียหน้า (โรเบิร์ต การ์ด) (เพนตากอน)
20% to contain China,	ยี่สิบเปอร์เซ็นต์คือยับยั้งจีน
and ten percent to help the Vietnamese.	และสิบเปอร์เซ็นต์คือการช่วยชาวเวียดนาม (ความลับสุดยอด ภาคผนวก - การดำเนินการสำหรับเวียดนามใต้)
[narrator] Johnson quietly told his good friend, Senator Richard Russell of Georgia,	จอห์นสันบอกเพื่อนที่ดีของเขา วุฒิสมาชิกริชาร์ด รัสเซลล์แห่งจอร์เจียเงียบๆ
what was about to happen.	ถึงสิ่งที่กำลังจะเกิดขึ้น
[Johnson] I guess we got no choice, but it scares the death out of me.	ผมเดาว่าเราไม่มีทางเลือก แต่มันก็ทำให้ผมกลัวแทบตาย
I think everybody's going to think,	ผมคิดว่าทุกคนจะต้องคิดว่า (ลินดอน จอห์นสัน) (ประธานาธิบดีสหรัฐอเมริกา)
"We're landing the Marines.	"เราจะส่งนาวิกโยธินไป
We're off to battle."	เราจะออกไปต่อสู้"
Of course, if they come up there,	แน่นอนว่าถ้าพวกเขามาที่นั่น
they're going to get them in a fight.	พวกเขาจะต้องต่อสู้กัน
And if they ruin those airplanes,	และถ้าพวกเขาทำลายเครื่องบินเหล่านั้น
everybody is going to give me hell for not securing them,	ทุกคนจะต่อว่าผมที่ไม่ป้องกันเครื่องบินพวกนั้น
just like they did last time they made a raid.	เหมือนตอนที่พวกเขาทำครั้งที่แล้วที่พวกนั้นโจมตี
[Russell] Yeah.	ใช่
[Johnson] What do you... What do you think?	คุณคิดว่ายังไง
[Russell] Well, Mr. President, it scares the life out of me.	ท่านประธานาธิบดี มันทำให้ผมกลัวสุดๆ (สว. ริชาร์ด รัสเซลล์) (เดโมแครต-จอร์เจีย)
But I don't know how to back up now.	แต่ตอนนี้ผมไม่รู้ว่าจะถอยยังไง
It looks to me like we just got in this thing,	สำหรับผมแล้วดูเหมือนเราเข้าไปในเรื่องนี้
and there's no way out.	และไม่มีทางออก
[Johnson] I don't know.	ไม่รู้สินะ
Uh, Dick, the great trouble I'm under...	ดิ๊ก ปัญหายิ่งใหญ่ที่ผมเผชิญ
A man can fight if he can see daylight	(ดานัง เวียดนามใต้ วันที่ 8 มีนาคม 1965) คนเราสามารถต่อสู้ได้ ถ้าเห็นแสงสว่างบนถนนสักแห่ง
down the road somewhere.	คนเราสามารถต่อสู้ได้ ถ้าเห็นแสงสว่างบนถนนสักแห่ง
But there ain't no daylight in Vietnam.	แต่มันไม่มีแสงสว่างในเวียดนาม
There's not a bit.	ไม่มีสักนิด
[narrator] On March 8, 1965, Dr. Phan Huy Quat,	ในวันที่ 8 มีนาคม 1965 ดร. ฟาน ฮุย ควอต
yet another prime minister of South Vietnam,	เป็นนายกรัฐมนตรีอีกคนของเวียดนามใต้
called his chief of staff, Bui Diem.	โทรหาบุ๋ย เดียม เสนาธิการของเขา
[Bui Diem speaking English] And Dr. Quat said,	และดร.ควอตพูดว่า
"There are three Marine battalions landing in Danang right now."	"ตอนนี้มีกองพันนาวิกโยธินสามกองขึ้นบกที่ดานัง" (บุ๋ย เดียม) (ทูตของเวียดนามใต้)
I was flabbergasted. I said, "But why?"	ผมแปลกใจและตกใจมาก ผมพูดว่า "ทำไมล่ะ"
So he calmed me down. He said that, "No, okay. We talk about it later.	เขาบอกให้ผมใจเย็น เขาพูดว่า "ไม่เป็นไร เราจะคุยเรื่องนี้ทีหลัง
But right now, try to be brief and draft a communique,	แต่ตอนนี้พยายามรวบรัด และร่างหนังสือแถลงการณ์
announcing the landing of three Marine battalions,	ประกาศเรื่องการขึ้นฝั่ง ของกองพันนาวิกโยธินสามกอง
and welcoming the landing in the same time."	และต้อนรับการขึ้นฝั่งในเวลาเดียวกัน"
I was very unhappy.	ผมรู้สึกไม่ดีเอามากๆ
[narrator] The Marines were landing at Danang	นาวิกโยธินขึ้นฝั่งที่ดานัง
on the east coast of South Vietnam, some 100 miles south	ทางชายฝั่งตะวันออกของเวียดนามใต้ ห่างออกไปทางใต้ 100 ไมล์
of the demilitarized zone that divided the North from the South.	ของเขตปลอดทหาร ที่แบ่งแยกฝ่ายเหนือจากฝ่ายใต้
They were prepared to fight their way ashore.	พวกเขาเตรียมพร้อม ที่จะต่อสู้ในระหว่างทางขึ้นฝั่ง
They did not need to.	พวกเขาไม่จำเป็นต้องทำ
[Philip Caputo] What struck me	สิ่งที่ผมสะดุดตาคือ
was how beautiful Vietnam was to look at.	เมื่อมองแล้วเวียดนามมีความสวยงามมาก (ขอต้อนรับนาวิกโยธินสหรัฐฯ)
There were just these endless acres of these jade-green rice paddies.	มีที่นากว้างสุดหูสุดตา ที่ปลูกข้าวสีเขียวเหมือนหยก
And these lovely villages inside these groves of bamboo and palm trees.	และหมู่บ้านที่น่ารักเหล่านี้ ด้านในป่าไผ่และต้นปาล์ม
And way off in the distance these bluish jungled mountains,	และห่างออกไปก็มีภูเขาที่มีป่าสีเขียว
and they looked like Shangri-La.	และดูเหมือนแชงกรีลา
And I remember seeing this line of Vietnamese women,	และผมจำได้ว่าเห็นแถวของผู้หญิงเวียดนาม (ฟิลิป คาปูโต้) (นาวิกโยธิน)
or schoolgirls I think they were.	หรือนักเรียนหญิงซึ่งผมคิดว่าน่าจะใช่
They actually looked like angels come to earth or something like that.	จริงๆ แล้วพวกเธอดูเหมือนนางฟ้า ที่ลงมาบนโลกหรืออะไรแบบนั้นเลย
So it was really quite striking, but a little unsettling because... [chuckling]	ดังนั้นมันน่าประทับใจมาก แต่ก็ไม่สบายใจเล็กน้อยเพราะ...
...so how can a place like this,	เป็นไปได้อย่างไรที่สถานที่แบบนี้
so beautiful and so enchanting, be at war?	ที่สวยงามและมีเสน่ห์มาก จะมีสงคราม
[Duong Van Mai] My father was very happy.	พ่อของฉันดีใจมาก
We're such a small and poor country	เราเป็นประเทศเล็กและยากจนมาก
and the Americans have decided to come in to save us	และชาวอเมริกันตัดสินใจที่จะมาช่วยพวกเรา
not only with their money, their resources,	ไม่เพียงด้วยเงินและทรัพยากรของพวกเขา (มิตรภาพของเวียดนามและอเมริกาจงเจริญ)
but even with their own lives.	แต่แม้กระทั่งด้วยชีวิตของพวกเขาเอง
We were very grateful. We thought the...	เราซาบซึ้งมาก (ดวง วัน มาย) (ไซ่ง่อน) เราคิดว่า...
Sure enough with this power, the Americans are going to win.	ฝ่ายอเมริกาจะชนะด้วยพลังนี้แน่นอน
[narrator] Seeing foreign troops marching past his village,	เมื่อเห็นกองทหารต่างชาติ เดินผ่านหมู่บ้านของเขา
an old man emerged from his home shouting, "Vivent les Francais!"	ชายแก่ออกมาจากบ้านและตะโกนว่า "ฝรั่งเศสจงเจริญ"
He thought the French had returned.	เขาคิดว่าฝรั่งเศสกลับมาอีกครั้ง
"The problem around here,"	"ปัญหาที่เกิดแถวนี้"
a Marine captain leading a patrol told a reporter,	หัวหน้านาวิกโยธินที่นำ หน่วยลาดตระเวนบอกผู้สื่อข่าวว่า
"is who the hell is who?"	"ไม่รู้ใครเป็นใคร"
[Wilson] As a voting member of Saigon Mission Council,	ตามสมาชิกที่ลงคะแนนของสภาภารกิจของไซ่ง่อน
I was opposed to the entry of American ground combat forces.	ผมถูกคัดค้านไม่ให้เข้าร่วม กองกำลังต่อสู้ภาคพื้นดินของอเมริกา
I felt if the Vietnamese had to beat them off	ผมรู้สึกว่าถ้าชาวเวียดนาม ต้องเอาชนะพวกเขาด้วยตอไม้
with a bloody stump, they had to do it themselves.	ผมรู้สึกว่าถ้าชาวเวียดนาม ต้องเอาชนะพวกเขาด้วยตอไม้ (แซม วิลสัน) (กองทัพ) พวกเขาต้องทำด้วยตัวเอง
We had to do everything we humanly could to help them,	เราต้องทำทุกอย่างที่เราทำได้ อย่างมนุษย์ธรรมดาเพื่อช่วยพวกเขา
but we could not win it for them.	แต่เราไม่สามารถเอาชนะมันเพื่อพวกเขาได้
So, I think we crossed the River Styx at that point.	ดังนั้นผมคิดว่าเราข้ามแม่น้ำแห่งความตายในจุดนั้น
[Ngoc Toan speaking English] In the deep of every Vietnamese mind,	ในส่วนลึกของจิตใจชาวเวียดนามทุกคน
foreigner is the invader.	ชาวต่างชาติคือผู้บุกรุก
So, when the American come in,	ดังนั้นเมื่อชาวอเมริกันเข้ามา
the Viet Cong can recruit more people	เวียดกงสามารถเกณฑ์คนได้มากขึ้น (ตรัน หง็อก ตวน) (นาวิกโยธินเวียดนามใต้)
to fight against the invader.	เพื่อต่อสู้กับผู้บุกรุก
[Bill Zimmerman] The first protest I went to against the war in Vietnam	(ดาว เคมิคอล ยูเอสเอ) (ดาว) การประท้วงครั้งแรกที่ผมไป เพื่อต่อต้านสงครามในเวียดนาม
was a protest at a Dow Chemical facility.	เป็นการประท้วงที่โรงงานดาว เคมิคอล
Dow was manufacturing napalm.	ดาวเป็นผู้ผลิตระเบิดนาปาล์ม
They were dropping napalm on villages in Vietnam.	พวกเขาจะท้ิงระเบิดนาปาล์ม ใส่หมู่บ้านในเวียดนาม
It was a very disappointing experience	มันเป็นประสบการณ์ที่น่าผิดหวัง
because only 40 people came.	เพราะมีคนมาเพียงแค่ 40 คน (บิล ซิมเมอร์แมน) (มหาวิทยาลัยชิคาโก)
And we seemed very out of place and very ineffectual, impotent,	เราดูผิดที่ผิดทาง ไร้ประโยชน์ และไร้กำลังมาก
standing outside with 40 people.	ยืนอยู่ด้านนอกกับคน 40 คน
[narrator] Most Americans understood little about Indochina,	ชาวอเมริกันส่วนใหญ่ แทบจะไม่เข้าใจเกี่ยวกับอินโดจีน
rarely knew anyone actually involved in the fighting,	แทบจะไม่รู้จักใครที่มีส่วนในการต่อสู้จริงๆ
saw no reason to question the government's assertion	ไม่เห็นเหตุผลที่จะตั้งคำถาม กับการยืนยันของรัฐบาลว่า
that the United States had vital interests 8,000 miles from home.	สหรัฐอเมริกามีผลประโยชน์สำคัญ ห่าง 8,000 ไมล์จากบ้านอย่างไร
Still, there was a small but growing number of people	แต่ยังมีคนจำนวนน้อยที่เพิ่มขึ้น
who had begun to oppose the war for any number of reasons.	ที่เริ่มจะต่อต้านสงครามด้วยเหตุผลต่างๆ (วันที่ 15 และ 16 ต.ค.) (ต่อต้านสงครามเวียดนาม)
Because they thought it unjust or immoral,	เพราะพวกเขาคิดว่า มันไม่ยุติธรรมหรือไร้ศีลธรรม
believed it was unconstitutional	เชื่อว่าไม่ถูกต้องตามรัฐธรรมนูญ
or simply not in the national interest.	หรือเพียงแค่ไม่ใช่ผลประโยชน์ของประเทศ
[Ochs] ♪ Oh I marched to the battle Of New Orleans... ♪	(ไม่เอาสงครามอีก โป๊ปพอล)
[narrator] Two weeks after the Marines landed at Danang,	สองสัปดาห์หลังจากที่นาวิกโยธินขึ้นฝั่งที่ดานัง
members of the University of Michigan faculty organized	สมาชิกของมหาวิทยาลัยมิชิแกนได้จัด
a night-long discussion between professors	การอภิปรายตลอดคืนระหว่างพวกอาจารย์
and some 3,000 students about the escalation of the war.	และนักเรียน 3,000 คน เกี่ยวกับการขยายสงคราม
The demonstration was called a teach-in	การประท้วงถูกเรียกว่าเป็นการสอน
because the idea originated with a group of university professors.	เพราะแนวคิดเกิดจาก กลุ่มอาจารย์ในมหาวิทยาลัย
What do you hope to accomplish?	คุณหวังจะบรรลุเป้าหมายอะไร
[Dr. Eric Wolf] I'd like to open up communication between people	ผมต้องการเปิดการสื่อสาร ระหว่างประชาชนและรัฐบาล
and the government, because I believe	ผมต้องการเปิดการสื่อสาร ระหว่างประชาชนและรัฐบาล เพราะผมเชื่อว่าพวกเขาไม่ได้บอกพวกเรา ถึงสิ่งที่กำลังเกิดขึ้น
that they are not telling us what is going on,	เพราะผมเชื่อว่าพวกเขาไม่ได้บอกพวกเรา ถึงสิ่งที่กำลังเกิดขึ้น
and the people have the right to know, and we have the right	และประชาชนมีสิทธิ์ที่จะรู้ เรามีสิทธิ์
to tell the government what we think.	ที่จะบอกรัฐบาลว่าเราคิดอะไร (ถอนทหารสหรัฐฯ)
[narrator] Soon, there were teach-ins on most major university campuses.	ในไม่ช้า มีการสอนแบบนี้ ในวิทยาเขตของมหาวิทยาลัยสำคัญส่วนมาก
There is no morally wonderful way out.	ไม่มีทางออกทางศีลธรรมที่ยอดเยี่ยม
[narrator] NYU in Manhattan, the University of Wisconsin in Madison,	เอ็นวายยูในแมนแฮตตัน มหาวิทยาลัยวิสคอนซินในเมดิสัน
the University of California in Berkeley.	มหาวิทยาลัยแคลิฟอร์เนียในเบิร์กลีย์
The teach-ins were really raucous affairs.	การสอนเป็นเหตุการณ์ที่จริงจังมาก
A lot of contention.	มีการโต้แย้งมากมาย
[student] ...we want to discuss is what's wrong with the Vietnam War, and...	เราต้องการอภิปรายสิ่งที่ไม่ถูกต้อง เกี่ยวกับสงครามเวียดนามและ...
♪ But I ain't marchin' Anymore ♪	(ออกจากเวียดนาม)
[reporter] Do you endorse the administration's policy in South Vietnam?	คุณเห็นด้วยกับนโยบาย ของฝ่ายบริหารในเวียดนามใต้หรือครับ
Whole-heartedly.	เห็นด้วยที่สุดครับ
[Zimmerman] There were plenty of times when people who were supportive of the war	มีหลายครั้งที่ประชาชนซึ่งสนับสนุนสงคราม
came to these teach-ins to try to give an alternative anticommunist point of view.	มาที่การสอนพวกนี้เพื่อพยายามให้ความคิดเห็น ทางเลือกของฝ่ายต่อต้านคอมมิวนิสต์
They were often shouted down.	พวกเขามักถูกตะโกนใส่
[narrator] The bombing of the North and the Marines' arrival	การทิ้งระเบิดของฝ่ายเหนือ และการมาถึงของนาวิกโยธิน
also drew protesters to Washington that spring.	ยังดึงดูดผู้ประท้วงมาที่วอชิงตันในฤดูใบไม้ผลินั้น (เวียดนามเพื่อชาวเวียดนาม)
The demonstration was organized	การประท้วงได้รับการจัดขึ้น...
by the Students for a Democratic Society, the SDS.	โดยนักเรียนเพื่อสังคมแห่งประชาธิปไตย เอส.ดี.เอส
I saw SDS calling for a demonstration at the White House in the spring of 1965.	ผมเห็นเอสดีเอสเรียกร้องให้มีการประท้วง ที่ทำเนียบขาวในฤดูใบไม้ผลิปี 1965
I didn't want to go because I didn't want to be disappointed	ผมไม่อยากไปเพราะผมไม่อยากผิดหวัง
in the same way again and, you know, go all the way to Washington	ในแบบเดียวกันอีกครั้งและเดินทางไปถึงวอชิงตัน
and stand outside the White House with 40 people.	ยืนด้านนอกทำเนียบขาวกับคน 40 คน
Twenty-five thousand people attended that rally.	มี 25,000 คนเข้าร่วมในการประท้วง
And that suddenly told me	และเรื่องนั้นบอกผมทันที และคนอื่นๆ ที่ผมทำงานด้วยในตอนนั้น
and others I was working with at the time	และเรื่องนั้นบอกผมทันที และคนอื่นๆ ที่ผมทำงานด้วยในตอนนั้น (ไม่เอานาปาล์ม เอาการเลือกตั้ง)
that it might be possible to build an antiwar movement.	มันเป็นไปได้ที่จะสร้าง ความเคลื่อนไหวเพื่อต่อต้านสงคราม (เทย์เลอร์จะหยุดหลอกลวง ชาวอเมริกันได้ไหม)
[Jean-Marie] It was quite astounding to think that he had that degree of commitment.	มันน่าประหลาดใจที่คิดว่า เขามีความมุ่งมั่นในระดับนั้น
And it made sense	และมันก็มีเหตุผล...
in what we knew of him, as drastic as it was.	(ฌ็อง-มารี คร็อกเกอร์) (ซาราโทกาสปริงส์ นิวยอร์ก) ในสิ่งที่เรารู้จักเขา ที่รุนแรงแบบที่เคยเป็น
["It's My Life" by the Animals playing] [narrator] Nothing Mogie Crocker's parents could say or do	พ่อแม่ของโมกี้ คร็อกเกอร์ ไม่สามารถพูดหรือทำอะไรได้
since Mogie had come home	ตั้งแต่โมกี้กลับมาบ้าน
shook his determination to serve,	เพื่อสลัดความตั้งใจของเขาที่จะรับใช้ชาติ
and recent developments in Vietnam had only strengthened his resolve.	และการพัฒนาล่าสุดในเวียดนาม ได้ทำให้การตัดสินใจของเขาแน่วแน่
He wanted to become a paratrooper and get into combat.	เขาต้องการเป็นทหารพลร่มและเข้าร่วมการต่อสู้
His parents finally, reluctantly,	ในที่สุดพ่อแม่ของเขาก็ฝืนใจยอมตกลงให้เขาไป
agreed to let him go, and on March 15,	ในที่สุดพ่อแม่ของเขาก็ฝืนใจยอมตกลงให้เขาไป และในวันที่ 15 มีนาคม หนึ่งสัปดาห์ หลังจากที่นาวิกโยธินทีมแรกขึ้นบกที่ดานัง
a week after the first Marines landed at Danang,	และในวันที่ 15 มีนาคม หนึ่งสัปดาห์ หลังจากที่นาวิกโยธินทีมแรกขึ้นบกที่ดานัง
Denton Crocker, Jr. entered the United States Army.	เดนตัน คร็อกเกอร์ จูเนียร์ เข้าร่วมกองทัพสหรัฐอเมริกา
[Jean-Marie] So Denton bounced down the steps one morning	เดนตันก็กระโดดลงบันไดในเช้าวันหนึ่ง
and was off to Fort Dix.	และเดินทางไปที่ฟอร์ตดิกซ์
It was in a way a sort of relief, actually,	จริงๆ แล้วมันก็ค่อนข้างโล่งอก
that the conflict and the anxiety	ที่ความขัดแย้งและความวิตกกังวล
over whether he would or would not go was done.	เรื่องเขาจะไปหรือไม่ไปจบลงเสียที
And he was happy.	และเขาก็มีความสุข
And we just tried to believe that this was the right thing for him to do.	เราพยายามที่จะเชื่อว่า นี่เป็นสิ่งถูกต้องที่เขาต้องทำ
[Le Minh Khue speaking Vietnamese] In the early days, I wasn't very scared.	ในช่วงแรกๆ ฉันไม่กลัวมากนัก
But when I saw dead people,	แต่เมื่อฉันเห็นคนตาย
that scared me.	ฉันจึงรู้สึกกลัว
The Americans bombed a village for hours.	ทหารอเมริกาทิ้งระเบิดใส่หมู่บ้านหลายชั่วโมง
We ran over to see what had happened.	เราวิ่งไปดูว่าเกิดอะไรขึ้น
The village was unrecognizable.	หมู่บ้านอยู่ในสภาพที่จำไม่ได้เลย (เล มินห์ เคว) (เวียดนามเหนือ)
From then on,	ตั้งแต่นั้นมา
I knew that war had arrived.	ฉันรู้ว่าสงครามได้มาถึงแล้ว
[narrator] Le Minh Khue was orphaned as a small girl,	เล มินห์ เควกำพร้าตั้งแต่เด็ก
her parents victims of the brutal land reforms the communists had imposed.	พ่อแม่ของเธอเป็นเหยื่อของการปฏิรูป ที่ดินโหดร้ายที่กำหนดโดยคอมมิวนิสต์
She was raised by her aunt and uncle,	เธอได้รับการเลี้ยงดูจากลุงและป้าของเธอ
who encouraged her to read American literature.	ซึ่งสนับสนุนให้เธออ่านวรรณกรรมของอเมริกา
She was 16 when Operation Rolling Thunder began.	เธออายุ 16 ปีตอนที่ปฏิบัติการสายฟ้าฟาดเริ่มต้น
[Minh Khue speaking Vietnamese] My house was next to a home for the elderly.	บ้านของฉันถัดจากบ้านสำหรับผู้สูงอายุ
It was completely destroyed.	ที่นั่นถูกทำลายอย่างสิ้นเชิง
Bombs fell on the market and the school.	ระเบิดตกลงที่ตลาดและโรงเรียน
Then, a recruiter came	จากนั้นเจ้าหน้าที่ที่เกณฑ์คนก็มา
asking for volunteers.	เพื่อขออาสาสมัคร
My head was full of a strong spirit of adventure.	ในหัวของฉันเต็มไปด้วย จิตวิญญาณแห่งการผจญภัยที่แรงกล้า
But I was too young. You had to be 17.	แต่ฉันอายุน้อยเกินไป คุณต้องมีอายุ 17 ปี
So I lied about my age and signed up.	ฉันเลยโกหกเรื่องอายุและสมัครไป
[narrator] Khue was assigned to an organization called	เควได้รับมอบหมายในองค์กรที่เรียกว่า
the "Youth Shock Brigades Against the Americans for National Salvation,"	กองพลเยาวชนต่อต้าน ทหารอเมริกันเพื่อการช่วยชาติ
and along with thousands of other young people	พร้อมกับเยาวชนคนอื่นๆ อีกหลายพันคน
was sent south to work keeping open the Ho Chi Minh Trail.	ถูกส่งไปทางใต้เพื่อทำงาน เพื่อคอยเปิดเส้นทางโฮจิมินห์
[Minh Khue speaking Vietnamese] Before I left, my uncle said,	ก่อนฉันจะไป ลุงของฉันพูดว่า
"American literature is very unique.	"วรรณกรรมของอเมริกามีเอกลักษณ์มาก
You should bring some with you."	เธอควรเอาติดตัวไปบ้างนะ"
I loved American literature ever since,	ฉันรักวรรณกรรมของอเมริกานับแต่นั้นมา
and in particular, I live Hemingway.	ฉันชอบเฮมิงเวย์เป็นพิเศษ
I learned from "For Whom the Bell Tolls."	ฉันเรียนรู้จากเรื่อง ฟอร์ ฮูม เดอะ เบล โทลส์
Like the resourcefulness of the man who destroys the bridge.	เหมือนความฉลาดของชายที่ทำลายสะพาน
I saw how he coped with war,	ฉันเห็นวิธีที่เขารับมือกับสงคราม
and I learned from that character.	และฉันเรียนรู้จากตัวละครนั้น
[narrator] As Johnson had feared,	ดังที่จอห์นสันกลัว
it quickly became clear that the bombing campaign alone was not working.	เห็นได้ชัดเจนอย่างรวดเร็วว่า ลำพังการต่อสู้ด้วยการทิ้งระเบิดไม่ได้ผล
Troops and supplies continued steadily to filter down the Ho Chi Minh Trail.	กำลังพลและสิ่งของยังคง ผ่านเส้นทางโฮจิมินห์อย่างสม่ำเสมอ
General Westmoreland and the Joint Chiefs	นายพลเวสต์มอร์แลนด์และเสนาธิการร่วม
called for more men, tens of thousands of them.	เรียกร้องทหารเพิ่มจำนวนหลายหมื่นนาย
The president was cautious.	ประธานาธิบดีมีความระมัดระวัง
He wanted to do "enough, but not too much," he said.	เขากล่าวว่าเขาต้องการทำ "อย่างเพียงพอแต่ไม่มากเกินไป"
But he quietly agreed to send two more Marine battalions	แต่เขาตกลงอย่างเงียบๆ ที่จะส่ง กองพันนาวิกโยธินไปอีกสองกอง
and changed their mission from base security to active combat.	และเปลี่ยนภารกิจของพวกเขาจากการรักษา ความปลอดภัยฐานทัพเป็นการต่อสู้เชิงรุก
For the first time,	เป็นครั้งแรก
American troops were being asked to fight on their own in Vietnam.	กองทหารอเมริกันถูกขอ ให้สู้ด้วยตัวเองในเวียดนาม
Johnson did not want that fact revealed to the American public either.	จอห์นสันไม่ต้องการให้ข้อเท็จจริงนั้น เปิดเผยต่อสาธารณชนชาวอเมริกันเช่นกัน
But the bombing of the North and rumors of harsher measures to come	แต่การระเบิดของฝ่ายเหนือ และข่าวลือของมาตรการที่รุนแรงที่จะเกิดขึ้น
had heightened concern around the world.	ทำให้เกิดความกังวลเพิ่มขึ้นทั่วโลก
UN Secretary-General U Thant had proposed a three-month ceasefire.	อูตัน เลขาธิการสหประชาชาติ ได้เสนอการหยุดรบสามเดือน
Great Britain, America's closest ally,	ประเทศอังกฤษ พันธมิตรที่สนิทที่สุดของอเมริกา
publicly offered to reconvene the Geneva Talks	ได้เสนอต่อสาธารณะ ที่จะเปิดประชุมใหม่ในการพูดคุยที่เจนีวา
that had divided Vietnam in 1954,	ที่แบ่งแยกเวียดนามในปี 1954
with the goal of reuniting it.	ด้วยเป้าหมายในการรวมประเทศ
[Johnson] The people of South Vietnam be allowed to guide their own country...	ประชาชนในเวียดนามใต้ ได้รับอนุญาตให้นำประเทศของตน
[narrator] On April 7, at Johns Hopkins University,	ในวันที่ 7 เมษายน ที่มหาวิทยาลัยจอนส์ฮอปกินส์
Johnson sought to persuade the world of America's good intentions	จอห์นสันต้องการโน้มน้าวโลก ถึงเจตนาที่ดีของอเมริกา
and again to calm American fears of a wider war.	และอีกครั้งเพื่อปลอบความกลัว ของชาวอเมริกันเรื่องสงครามที่ขยายวง
In recent months, attacks on South Vietnam were stepped up.	ในเดือนล่าสุด การโจมตีเวียดนามใต้เพิ่มขึ้น
Thus, it became necessary for us to increase our response	ดังนั้น เราจึงจำเป็นต้องเพิ่มการตอบโต้
and to make attacks by air.	และทำการโจมตีทางอากาศ
This is not a change of purpose.	นี่ไม่ใช่การเปลี่ยนจุดประสงค์
It is a change in what we believe that purpose requires.	มันเป็นการเปลี่ยนสิ่งที่เราเชื่อว่า จุดประสงค์นั้นต้องการ
[narrator] Nothing was said about the new orders sending Marines directly into combat.	ไม่มีคำพูดใดเกี่ยวกับคำสัั่งใหม่ ที่ส่งนาวิกโยธินไปต่อสู้โดยตรง
Instead, the president called for "unconditional discussions"	แต่ประธานาธิบดีเรียกร้อง ให้มีการพูดคุยกับฮานอยโดยไม่มีเงื่อนไข
with Hanoi, and as an old New Dealer,	แต่ประธานาธิบดีเรียกร้อง ให้มีการพูดคุยกับฮานอยโดยไม่มีเงื่อนไข และในฐานะผู้ตกลงใหม่คนเก่า
proposed a massive development program for all of Southeast Asia.	เสนอโครงการพัฒนาขนาดใหญ่ สำหรับเอเชียตะวันออกเฉียงใต้ทั้งหมด
[Johnson] The vast Mekong River can provide food and water and power	แม่น้ำแม่โขงที่กว้างใหญ่ สามารถให้อาหาร น้ำ และพลังงาน
on a scale to dwarf even our own TVA.	ในระดับที่ทำให้บริษัททีวีเอเล็กลงไปเลย
[Brady] I was outside of the village.	ผมอยู่นอกหมู่บ้าน
We're getting some fire from the village.	เรากำลังจะไปเอาไฟจากหมู่บ้าน
I had the little transistor radio.	ผมมีวิทยุทรานซิสเตอร์เล็กๆ
And I'm sitting there listening to LBJ.	และผมก็นั่งตรงนั้นฟังปธน. พูด
[Johnson] ...will use our power with restraint and with all the wisdom...	จะใช้พลังของเราด้วยความยับยั้ยง และด้วยสติปัญญาทั้งหมด
At the same time we got to lay some nape on the village.	ในเวลาเดียวกันเราต้อง วางระเบิดนาปาล์มในหมู่บ้าน (ฟิลิป เบรดี้) (ที่ปรึกษาของนาวิกโยธิน)
So I'm calling in the nape	ผมจึงเรียกให้ทิ้งระเบิดนาปาล์ม
and listening to the president talk peace.	และฟังประธานาธิบดีพูดถึงสันติภาพ
[Johnson] We will try to keep conflict from spreading.	เราจะพยายามไม่ให้ความขัดแย้งแพร่ขยาย
[Brady] It was surreal.	เหมือนฝันจริงๆ
[Johnson] We have no desire to devastate	เราไม่ได้ปรารถนาที่จะทำลายล้าง สิ่งที่ประชาชนของเวียดนามเหนือ
that which the people of North Vietnam have built	เราไม่ได้ปรารถนาที่จะทำลายล้าง สิ่งที่ประชาชนของเวียดนามเหนือ ได้สร้างขึ้นด้วยความตรากตรำและเสียสละ
with toil and sacrifice.	ได้สร้างขึ้นด้วยความตรากตรำและเสียสละ
This war, like most wars, is filled with terrible irony.	สงครามนี้เหมือนสงครามส่วนใหญ่ ที่เต็มไปด้วยการเย้ยหยันแย่ๆ
What do the people of North Vietnam want?	ประชาชนของเวียดนามเหนือต้องการอะไร
[narrator] Hanoi denounced the president's offer as a trick.	ฮานอยยกเลิกข้อเสนอ ของประธานาธิบดีเพื่อเป็นอุบาย
Johnson's advisors and the Joint Chiefs of Staff	ที่ปรึกษาของจอห์นสันและคณะเสนาธิการร่วม
continued to debate how many men would actually be needed	ยังคงอภิปรายถึงจำนวนทหารที่จำเป็นจริงๆ
and how rapidly they should be deployed.	และควรเรียกประจำการพวกเขาเร็วแค่ไหน
Meanwhile, the president sent the first Army combat troops to the country.	ในเวลาเดียวกัน ประธานาธิบดีส่ง กองทหารต่อสู้ของทัพบกไปยังประเทศนั้น
It was increasingly clear	เป็นที่ชัดเจนเพิ่มขึ้นว่า
that the United States was in it for the long haul.	สหรัฐอเมริกาเข้าร่วมในระยะยาว
You can't just be a neutral witness to something like war.	คุณไม่สามารถเป็นพยานที่เป็นกลางได้... (โจ กัลโลเวย์) (นักหนังสือพิมพ์) ต่อบางสิ่งเช่นสงคราม
It crawls down your throat.	มันคืบคลานลงสู่คอของคุณ
It eats you alive from the inside and the out.	มันกลืนกินคุณทั้งเป็นจากข้างในและข้างนอก
It's not something that you can stand back and be neutral	ไม่ใช่สิ่งที่คุณสามารถถอยหลังและเป็นกลาง
and objective and all of those things we try to be	ไม่ลำเอียงและทุกอย่างที่เราพยายามจะเป็น
as reporters, journalists, photographers.	ในฐานะผู้สื่อข่าว นักหนังสือพิมพ์ ช่างภาพ
It doesn't work that way.	มันไม่เป็นเช่นนั้น
[man on radio] They're fast and they're real quick... And check it out...	การป้องกันและพวกเขาเร็วมาก ต้องตรวจสอบ
[narrator] The growing presence of American combat troops in Vietnam	การเพิ่มขึ้นของกองทหารสู้รบ ของอเมริกาในเวียดนาม
attracted flocks of journalists.	ดึงดูดกลุ่มนักหนังสือพิมพ์
There was no press censorship, as there had been in World War II.	ไม่มีการเซ็นเซอร์สื่อ อย่างที่เคยมีในสงครามโลกครั้งที่สอง
Reporters just had to agree to follow military guidelines	ผู้สื่อข่าวแค่ต้องตกลงที่จะทำตาม คำแนะนำทางทหารเท่านั้น
so as not to compromise the security of ongoing operations.	เพื่อที่จะไม่ทำลายความปลอดภัย ของปฏิบัติการที่ดำเนินอยู่
It was dangerous work.	มันเป็นงานที่อันตราย
More than 200 journalists and photographers would die	นักหนังสือพิมพ์และช่างภาพ มากกว่า 200 คนอาจเสียชีวิต
covering the fighting in Southeast Asia.	ในการทำข่าวการต่อสู้ในเอเชียตะวันออกเฉียงใต้
Joseph Lee Galloway was a young UPI reporter	โจเซฟ ลี กัลโลเวย์์เป็นผู้สื่อข่าวอายุน้อย ของยูพีไอจากรีฟิวจีโอ เท็กซัส
from Refugio, Texas.	โจเซฟ ลี กัลโลเวย์์เป็นผู้สื่อข่าวอายุน้อย ของยูพีไอจากรีฟิวจีโอ เท็กซัส (บัตรสื่อมวลชน) (ชื่อ โจเซฟ กัลโลเวย์์ เจอาร์)
He stopped in Saigon just long enough to get his credentials.	เขาหยุดพักที่ไซ่ง่อนนานพอ ที่จะได้รับหนังสือรับรอง
Then he headed for Danang.	จากนั้นเขามุ่งหน้าไปดานัง
[Galloway] The Marines originally came ashore there to guard the airbase.	ตอนแรกนาวิกโยธินขึ้นฝั่งที่นั่น เพื่อปกป้องฐานทัพอากาศ
And they quickly figured out you can't just guard an airbase.	และพวกเขาพบอย่างรวดเร็วว่า คุณไม่สามารถป้องกันฐานทัพอากาศได้
You've got to spread out because they're going to mortar it,	คุณต้องขยายออกไป เพราะพวกเขาจะยิงปืนครกใส่
they're going to shoot rockets.	พวกเขาจะยิงจรวดใส่
So you've got to reach out 15 or 20 miles.	ดังนั้นคุณต้องออกไป 15 หรือ 20 ไมล์
That means you've got to run operations that far out.	หมายความว่าคุณต้องทำการปฏิบัติการที่ไกลออกไป
And once you're doing that, you're no longer guarding an airbase...	เมื่อคุณทำเช่นนั้น คุณก็จะไม่ได้ป้องกันฐานทัพอากาศ
...you're operating in hostile territory.	คุณจะปฏิบัติการในเขตแดนของศัตรู
[Nguyen Thanh Son speaking Vietnamese] No matter how strong you are,	ไม่ว่าคุณจะแข็งแกร่งเพียงใด
if you aren't familiar with the battlefield,	ถ้าคุณไม่คุ้นเคยกับสนามรบ
with the climate,	กับสภาพอากาศ
with the local customs,	กับประเพณีในท้องถิ่น
it will be very tough.	มันจะเป็นเรื่องยากมาก
The Americans were very tall and slow.	ทหารอเมริกันตัวสูงและช้ามาก (เหงียน ถั่ญ เซิน) (กองทัพเวียดนามเหนือ)
They weren't as quick as our soldiers.	พวกเขาไม่เร็วเท่าทหารของเรา
[Caputo] It wasn't so much the Viet Cong that were intimidating	ในจุดนั้นเวียดกงไม่ได้น่ากลัวมาก
at that point as it was the terrain.	เท่ากับภูมิประเทศ
Going from Point A to Point B in the jungle	การไปจากจุดเอถึงจุดบี... (ฟิลิป คาปูโต้) (นาวิกโยธิน) ในป่าเป็นเรื่องยากมาก
was so difficult.	ในป่าเป็นเรื่องยากมาก
As it happened to me once, it took four hours	มันเคยเกิดขึ้นกับผมครั้งหนึ่ง ผมใช้เวลาสี่ชั่วโมง
to move a half a mile,	เพื่อเดินทางครึ่งไมล์
cutting through this bush with machetes.	โดยตัดผ่านพุ่มไม้ด้วยมีดสปาร์ตา
[Galloway] The Viet Cong knew the terrain far better than the Marines did,	เวียดกงรู้จักภูมิประเทศดีกว่านาวิกโยธิน
and ran circles around them.	และวิ่งวนรอบพวกเขา
[Mogie Crocker dramatized] Fort Dix, June 10, 1965.	ฟอร์ตดิกซ์ วันที่ 10 มิถุนายน 1965
Dear Mom,	ถึงคุณแม่
Basic is now all over and I am presently waiting for orders.	พื้นฐานจบหมดแล้วและตอนนี้ผมกำลังรอคำสั่ง
Waiting for orders could be very dull,	การรอคำสั่งเป็นเรื่องน่าเบื่อมาก
but I have found there are excellent chances	แต่ผมพบว่ามีโอกาสที่ดี
to do some reading.	ที่จะได้อ่านหนังสือ
Recently I have read Wuthering Heights,	ช่วงนี้ผมอ่านเรื่อง วัทเทอริง ไฮท์ส
Animal Farm, Seven Pillars of Wisdom, and Lord Jim.	แอนิมอล ฟาร์ม เซเว่น พิลลาร์ ออฟ วิสดอม และลอร์ดจิม
I hope you are all well.	ผมหวังว่าทุกคนจะสบายดีนะ
Love, Mogie.	ด้วยรัก โมกี้
[narrator] Mogie Crocker was allowed two weeks at home	โมกี้ คร็อกเกอร์ได้รับอนุญาต ให้กลับบ้านสองสัปดาห์
before shipping out to Vietnam.	ก่อนที่จะเดินทางไปเวียดนาม
[Jean-Marie] We were at dinner one evening	เราทานมื้อค่ำกันในเย็นวันหนึ่ง
just talking, I guess, in generalities about the war	แค่คุยกันเรื่องทั่วไปเกี่ยวกับสงคราม
and the general situation.	และสถานการณ์ทั่วไป
And Mogie said, "Of course if I were a Vietnamese,	โมกี้พูดว่า "แน่นอนว่าถ้าผมเป็นชาวเวียดนาม
I would be on the side of the Viet Cong."	ผมคงอยู่ฝ่ายเวียดกง"
That... I puzzled over that.	ฉันคิดหนักเกี่ยวกับเรื่องนั้น
I suppose relating like to our American Revolution	ฉันว่าการเทียบกับการปฏิรูปของอเมริกา
that he saw their need for their own freedom.	ที่เขาเห็นความต้องการเพื่อเสรีภาพของพวกเขา
But as an American citizen,	แต่ในฐานะพลเมืองชาวอเมริกัน
he saw the larger picture of trying to prevent communism.	เขาเห็นภาพที่ใหญ่กว่า ของการพยายามป้องกันลัทธิคอมมิวนิสต์
[Carol Crocker] I remember one night in particular	ฉันจำได้ว่ามีอยู่คืนหนึ่ง
he and I were up late.	เขากับฉันอยู่จนดึก
And he suddenly leaned his head in his hands.	ทันใดนั้นเขากุมหัวตัวเอง
And he said, "I don't want to go back."	และพูดว่า "ผมไม่อยากกลับไป"
I was dumbstruck.	ฉันตะลึงจนพูดไม่ออก
And said to him, "But this is what you want to do."	และพูดกับเขาว่า "แต่นี่เป็นสิ่งที่เธออยากทำนะ"
It had never occurred to me that he was torn about this,	ฉันไม่เคยเห็นเขากังวลเรื่องนี้มาก่อนเลย
that he was afraid and yet was determined to go.	เขากลัวแต่ก็ยังมุ่งมั่นที่จะไป
[narrator] In South Vietnam, things were steadily growing worse.	ในเวียดนามใต้ เรื่องต่างๆ เลวร้ายลงอย่างคงที่
[narrator] In May, the Viet Cong,	ในเดือนพฤษภาคม เวียดกง
supported now by four regiments of North Vietnamese regulars,	ที่ได้รับการสนับสนุนโดยกองทัพ พลทหารเวียดนามเหนือสี่กอง
approximately 5,000 men,	ประมาณ 5,000 นาย
were destroying the equivalent of a South Vietnamese battalion every week.	กำลังทำลายกองพันของเวียดนามใต้ทุกสัปดาห์
South Vietnam now seemed only weeks from complete collapse.	ตอนนี้เวียดนามใต้ดูจะล่มสลาย อย่างสมบูรณ์ในอีกไม่กี่สัปดาห์เท่านั้น
Desperate, General Westmoreland requested	นายพลเวสต์มอร์แลนด์ที่สิ้นหวังมีคำขอ
tens of thousands of more American troops right away.	กองทัพทหารอเมริกันเพิ่มอีกหลายหมื่นทันที
But neither the continuing bombing	แต่ทั้งการทิ้งระเบิดต่อไป
nor the growing likelihood of full-scale American intervention	หรือความเป็นไปได้ ของการแทรกแซงเต็มที่ของอเมริกา
seemed to intimidate Hanoi.	ดูจะไม่ทำให้ฮานอยกลัว
Le Duan, having failed to win the war	เล สวนที่ไม่สามารถเอาชนะในสงครามได้
before the United States sent in ground troops,	ก่อนที่สหรัฐอเมริกาจะส่งกองทหารราบมา
was now persuaded the American public,	ตอนนี้ถูกโน้มน้าวโดยสาธารณชนอเมริกัน เหมือนสาธารณชนฝรั่งเศสก่อนหน้าพวกเขา
like the French public before them, would eventually weary	ตอนนี้ถูกโน้มน้าวโดยสาธารณชนอเมริกัน เหมือนสาธารณชนฝรั่งเศสก่อนหน้าพวกเขา ในที่สุดเขาก็เป็นกังวลเกี่ยวกับ สงครามราคาแพงและนองเลือด
of a costly, bloody war being waged so far from home.	ในที่สุดเขาก็เป็นกังวลเกี่ยวกับ สงครามราคาแพงและนองเลือด ซึ่งมีการต่อสู้ไกลจากบ้านมาก
By contrast, he said, "The North will not count the cost."	ในทางตรงข้่าม เขาบอกว่า "ฝ่ายเหนือจะไม่นับค่าใช้จ่าย"
Le Duan's confidence was bolstered	ความมั่นใจของเล สวนได้รับการสนับสนุน จากความช่วยเหลือที่การแทรกแซงของอเมริกา
by the help American intervention had forced	ความมั่นใจของเล สวนได้รับการสนับสนุน จากความช่วยเหลือที่การแทรกแซงของอเมริกา ได้บังคับให้สหภาพโซเวียตและจีนเสนอให้กับเขา
the Soviet Union and China to offer him.	ได้บังคับให้สหภาพโซเวียตและจีนเสนอให้กับเขา
Moscow agreed to supply vast amounts of modern weaponry and materiel.	มอสโกตกลงที่จะส่ง อาวุธสมัยใหม่และวััตถุดิบจำนวนมาก
Hanoi would eventually become the most heavily defended city on Earth.	ในที่สุดฮานอยจะเป็นเมือง ที่ได้รับการปกป้องอย่างแน่นหนาที่สุดในโลก
And China agreed to send support troops,	และจีนตกลงส่งกองทหารสนับสนุนมา
freeing North Vietnamese soldiers for combat in the South.	เพื่อปลดปล่อยทหารเวียดนามเหนือ สำหรับการต่อสู้ในฝ่ายใต้
320,000 Chinese would eventually serve behind the lines in the North.	ในที่สุดทหารจีน 320,000 นาย จะทำหน้าที่หลังเส้นในฝ่ายเหนือ
"We will fight," Le Duan promised, "whatever way the United States wants."	"เราจะต่อสู้" เล สวนสัญญา "ไม่ว่าด้วยทางไหนที่สหรัฐฯ ต้องการ"
[John Negroponte] In June of 1965,	ในเดือนมิถุนายน ปี 1965
Secretary McNamara, the Secretary of Defense, came out to Saigon.	รัฐมนตรีแมคนามาร่า... (จอห์น เนโกรพอนเต้) (สถานทูตสหรัฐ) รัฐมนตรีกระทรวงกลาโหมมาที่ไซ่ง่อน
There were a lot of captains and majors and lieutenants.	มีนาวาเอก พลเรือตรี และเรือโทหลายนาย
And every person said to Mr. McNamara,	และทุกคนพูดกับแมคนามาร่าว่า
"The situation is so dire we must bring in United States forces."	"สถานการณ์แย่มาก เราต้องนำกองกำลังของสหรัฐมา"
So, whatever doubts we may have had,	ดังนั้น ไม่ว่าเราอาจจะสงสัยอะไรก็ตาม
whatever people may say after the fact,	ไม่ว่าประชาชนจะพูดอะไรก็ตาม หลังจากข้อเท็จจริง
I recall distinctly at the time	ตอนนั้นผมจำได้อย่างชัดเจนว่า
telling the Secretary of Defense	ได้บอกรัฐมนตรีกระทรวงกลาโหมว่า
that I thought we needed to bring troops in there.	ผมคิดว่าเราต้องนำกองทัพไปที่นั่น
[narrator] For three weeks,	เป็นเวลาสามสัปดาห์
the president and his advisors argued over how to respond	ประธานาธิบดีและที่ปรึกษาของเขา เร่งว่าจะตอบสนองอย่างไร
to Westmoreland's urgent request for more troops,	ต่อคำขอเร่งด่วนของเวสต์มอร์แลนด์ ที่ขอกองทหารเพิ่มอีก
differing mostly over how many should be sent how fast.	ความแตกต่างส่วนใหญ่ เรื่องจำนวนที่ควรส่งไปเร็วแค่ไหน
Undersecretary of State, George Ball, made the argument against further escalation.	จอร์จ บอล ปลัดกระทรวงการต่างประเทศ โต้แย้งการยกระดับเพิ่ม
He told the president the war could not be won.	เขาบอกประธานาธิบดีว่า เราไม่อาจเอาชนะสงครามได้
The American people will grow weary of it.	ประชาชนชาวอเมริกันจะเริ่มกังวลถึงสงคราม
Our troops will get bogged down	กองทหารของเราจะจมปลัก
"in the jungles and rice paddies," he warned,	"ในป่าและนาข้าว" เขาเตือน
"while we slowly blow the country to pieces."	"ในขณะที่เราทำลายประเทศเป็นชิ้นๆ อย่างช้าๆ"
No one else agreed.	ไม่มีคนอื่นเห็นด้วย
In the end, Johnson sent Westmoreland 50,000 men.	ท้ายที่สุด จอห์นสันส่ง ทหาร 50,000 นายให้เวสต์มอร์แลนด์
But he pledged another 50,000 by the end of 1965,	และเขาขออีก 50,000 นายภายในสิ้นปี 1965
and still more if they were needed.	และเพิ่มอีกหากจำเป็นต้องใช้พวกเขา
[Ngoc Toan speaking English] When the Americans come in 1965,	เมื่อทหารอเมริกันมาในปี 1965
everything mess up in South Vietnam.	ทุกอย่างยุ่งเหยิงในเวียดนามใต้
Nobody know about the country, the people,	ไม่มีใครรู้เกี่ยวกับประเทศหรือประชาชน (ตรัน หง็อก ตวน) (นาวิกโยธินเวียดนามใต้)
the ground they fought.	พื้นที่ที่เขาต่อสู้
I think it's,	ผมคิดว่า
it's a big mistake.	เป็นข้อผิดพลาดครั้งใหญ่
[man] Hold your fire!	วางอาวุธลง
Hold your fire.	อย่าเพิ่งยิง
[John Scali] Does the fact that you are sending additional forces to Vietnam	ข้อเท็จจริงที่คุณส่งกองกำลังเพิ่มเติมไปเวียดนาม
imply any change in the existing policy	บอกเป็นนัยถึงการเปลี่ยนแปลงในนโยบายที่มีอยู่
of using American forces to guard American installations	ของการใช้กองกำลังอเมริกัน เพื่อป้องกันค่ายทหารของอเมริกา
and to act as an emergency backup?	และเพื่อทำหน้าที่เป็นการสำรองยามฉุกเฉินใช่ไหม
It does not imply any change in policy whatever.	ไม่ได้บอกเป็นนัย ถึงการเปลี่ยนแปลงนโยบายอะไรทั้งนั้น
It does not imply any change of objective.	ไม่ได้บอกเป็นนัยถึงการเปลี่ยนแปลงวัตถุประสงค์
[Lou Cioffi] The month of June saw soldiers here taking what appears to be...	เดือนมิถุนายน เห็นทหารที่นี่ พูดคุยถึงสิ่งที่ดูเหมือนจะเป็น...
[narrator] Most television reports from Vietnam	รายงานทางโทรทัศน์ส่วนใหญ่จากเวียดนาม
echoed the newsreels Americans had flocked to see	สะท้อนถึงภาพยนตร์ข่าวที่ชาวอเมริกันรวมตัวกันดู
during the Second World War. Enthusiastic, unquestioning,	ในช่วงสงครามโลกครั้งที่สอง คนดีที่กระตือรือล้น ไร้คำถาม
good guys fighting and defeating bad guys.	ที่ต่อสู้และเอาชนะคนไม่ดี
But at dinnertime on August 5, 1965,	แต่ในเวลามื้อค่ำของวันที่ 5 สิงหาคม 1965
Americans saw another side of the war.	ชาวอเมริกันเห็นอีกด้านของสงคราม
[Morley Safer] We're on the outskirts of the village of Cam Ne	เราอยู่รอบนอกของหมู่บ้านในแคมเน
with elements of the 1st Battalion...	พร้อมกองพันที่หนึ่งจำนวนเล็กน้อย
[narrator] CBS correspondent Morley Safer and his crew	มอร์ลีย์ เซเฟอร์นักข่าวของซีบีเอส และคณะของเขา
went on patrol with Marines near Danang.	ไปลาดตระเวนกับนาวิกโยธินใกล้ดานัง
Their orders were first to search a cluster	คำสั่งแรกของพวกเขา คือการค้นหากลุ่มหมู่บ้านสี่แห่ง
of four villages for caches of arms and rice	คำสั่งแรกของพวกเขา คือการค้นหากลุ่มหมู่บ้านสี่แห่ง เพื่อหาที่เก็บอาวุธและข้าวที่มีความหมายต่อศัตรู
meant for the enemy and then to destroy them all.	เพื่อหาที่เก็บอาวุธและข้าวที่มีความหมายต่อศัตรู จากนั้นก็ทำลายของพวกนั้นให้หมด
This is what the war in Vietnam is all about.	นี่เป็นสิ่งที่เกิดขึ้นในสงครามเวียดนาม
The old and the very young.	คนแก่และคนหนุ่มสาว
The Marines have burned this old couple's cottage	นาวิกโยธินได้เผากระท่อม ของคู่สามีภรรยาวัยชราคู่นี้
because fire was coming from here.	เพราะมีการยิงปืนมาจากตรงนี้
And now when you walk into the village you see no young people at all.	ตอนนี้เมื่อคุณเดินเข้าไปในหมู่บ้าน คุณจะไม่เห็นคนหนุ่มสาวเลย
[Safer] The day's operation burned down 150 houses,	ปฏิบัติการของวันนั้นเผาบ้าน 150 หลัง
wounded three women, killed one baby,	ผู้หญิงได้รับบาดเจ็บสามราย ทารกเสียชีวิตหนึ่งราย
wounded one Marine, and netted these four prisoners.	นาวิกโยธินได้รับบาดเจ็บหนึ่งนาย และจับนักโทษไปสี่คน
Today's operation is the frustration of Vietnam in miniature.	ปฏิบัติการในวันนี้ เป็นความไม่พอใจของเวียดนามในภาพย่อส่วน
There is little doubt that American firepower	มีความสงสัยเล็กน้อยว่ากำลังอาวุธของอเมริกา
can win a military victory here.	สามารถได้รับชัยชนะทางทหารที่นี่ได้
But to a Vietnamese peasant whose home is a... Means a lifetime of backbreaking labor,	แต่สำหรับชาวนาเวียดนามที่บ้านของเขา หมายถึงแรงงานที่เหน็ดเหนื่อยมาตลอดชีวิต
it will take more than presidential promises	จะต้องใช้มากกว่าคำสัญญาของประธานาธิบดี
to convince him that we are on his side.	ที่จะทำให้เขาเชื่อว่าเราอยู่ฝ่ายเขา
[narrator] The next morning, the president called his friend Frank Stanton, the head of CBS.	เช้าวันถัดมา ประธานาธิบดีโทรหาเพื่อนของเขา แฟรงก์ สแตนตัน หัวหน้าของซีบีเอส
"Hello, Frank, this is your president.	"สวัสดีแฟรงก์ นี่ประธานาธิบดีของคุณนะ
Are you trying to fuck me?"	คุณกำลังพยายามเล่นงานผมหรือไง"
Safer had defaced the American flag, Johnson said.	จอห์นสันบอกว่า เซเฟอร์ทำให้ธงชาติอเมริกาเสียหาย
He was probably an agent of the Kremlin, had to be fired.	เขาอาจจะเป็นสายลับของเครมลิน ต้องถูกไล่ออก
The Marines claimed Safer had provided a Zippo lighter	นาวิกโยธินอ้างว่าเซเฟอร์ให้ไฟแช็กซิปโป้
and asked the Marines to burn the hut for the camera.	และขอให้นาวิกโยธินเผากระท่อมต่อหน้ากล้อง
A major at the Danang Marine press office	พันตรีนายหนึ่งที่สำนักงานข่าวนาวิกโยธินของดานัง
called CBS the "Communist Broadcasting System."	เรียกซีบีเอสว่า "ระบบออกอากาศของคอมมิวนิสต์"
But after the operation,	แต่หลังจากการปฏิบัติการ
Safer interviewed some of the Marines who'd burned Cam Ne.	เซเฟอร์สัมภาษณ์นาวิกโยธินบางนายที่เผาแคมเน
Do you ever have any private thoughts,	คุณมีความคิดหรือความเสียใจส่วนตัว
any private regrets about some of these people	คุณมีความคิดหรือความเสียใจส่วนตัว เกี่ยวกับพวกคนที่คุณทำให้พวกเขาไร้บ้านไหม
you are leaving homeless?	เกี่ยวกับพวกคนที่คุณทำให้พวกเขาไร้บ้านไหม
I feel no remorse. I don't imagine anybody else does.	ผมไม่รู้สึกเสียใจนะ ผมไม่คิดว่าคนอื่นจะเสียใจด้วย
You can't expect to do your job and feel pity for these people.	คุณหวังว่าจะทำหน้าที่ของตัวเอง และรู้สึกสงสารคนพวกนั้นไม่ได้หรอก
[narrator] When some viewers registered their shock,	เมื่อผู้ชมบางรายแสดงความตกใจ
Westmoreland admitted, "We have a genuine problem	เวสต์มอร์แลนด์ยอมรับว่า "เรามีปัญหาอย่างแท้จริง
which will be with us as long as we are in Vietnam.	ที่จะอยู่กับเราตราบใดที่เราอยู่ในเวียดนาม
Commanders must exercise restraint unnatural to war	ผู้บัญชาการต้องใช้การยับยั้งที่ผิดปกติต่อสงคราม
and judgment not often required of young men."	และการตัดสินที่มักไม่จำเป็นของคนหนุ่ม"
[Caputo] You kind of thought at first	คุณอาจคิดในตอนแรกว่า
that it was going to be like the GIs, you know,	มันจะต้องเป็นเหมือนจีไอ นึกออกไหม
rolling through Paris after the liberation.	ที่เคลื่อนผ่านปารีสหลังจากการปลดปล่อย
Well, you know, it sure didn't work out that way.	รู้ไหม มันไม่ได้ออกมาเป็นแบบนั้น
I can remember once going in this one ville.	ผมจำได้ว่าเคยไปที่หมู่บ้านนี้
And I remember finding this entire Vietnamese family	และผมจำได้ว่าพบชาวเวียดนามทั้งครอบครัวนี้
cowering in a bunker.	กำลังหมอบอยู่ในหลุมหลบภัย
And they were terrified of us.	พวกเขากลัวเรา
And I remember thinking to myself, I said,	ผมจำได้ว่าพูดกับตัวเองในใจว่า
"Well, I wonder if back in the colonial days,	"ผมสงสัยว่าถ้าย้อนกลับไปยุคล่าอาณานิคม... (ฟิลิป คาปูโต้) (นาวิกโยธิน)
when the Redcoats barged into Ipswich, Massachusetts, or wherever,	เมื่อทหารอังกฤษเข้าไปที่อิปสวิช แมสซาชูเซตส์ หรือที่ไหนก็ตาม
if this is how Americans must have felt	ถ้านี่เป็นสิ่งที่ทหารอเมริกันต้องรู้สึก
looking at these foreign soldiers coming in here."	ตอนมองดูทหารต่างชาติพวกนี้มาที่นี่"
[Frederick Ackerson] The Viet Cong have terrorized you, and have burned your homes.	เวียดกงคุกคามคุณและเผาบ้านของคุณ
We are here to help you.	เรามาที่นี่เพื่อช่วยคุณ
To show how much we are able to protect you,	เพื่อแสดงว่าเราสามารถปกป้องคุณได้มากแค่ไหน
we are going to have the Air Force	เราจะให้กองทัพอากาศ
hit some Viet Cong on the other side of the valley.	โจมตีเวียดกงที่อยู่อีกด้านของหุบเขา
That will be at 10:30.	ซึ่งจะเป็นตอนเวลาสิบโมงครึ่ง
[Crocker dramatized] Dear Mom and Dad,	ถึงพ่อและแม่
I am now with the 1st Brigade, 101st Airborne Division in Vietnam.	ตอนนี้ผมอยู่ในกองพลน้อยที่หนึ่ง กองพลส่งทางอากาศที่ 101 ในเวียดนาม
What is taking place in America?	(เขตของตำรวจ ประชาชนเวียดนามต้องการสันติ) เกิดอะไรขึ้นในอเมริกา
We who are in Vietnam find these protests very hard to comprehend,	เราที่อยู่ในเวียดนามคิดว่าการประท้วงพวกนี้ ยากมากที่จะเข้าใจ
and many people here are quite bitter about them.	และหลายคนที่นี่ค่อนข้างไม่พอใจพวกเขา
The belief I have in our present policy	ความเชื่อที่ผมมีในนโยบายปัจจุบันของเรา
has been completely confirmed by what I have seen here.	ได้รับการยืนยันอย่างแน่นอนโดยสิ่งที่ผมได้เห็นที่นี่
My chief worry is that these pacifist bleatings	ความกังวลหลักของผมคือ เสียงบ่นของนักสันติเหล่านี้
might affect even a small change in government policy	อาจมีผลต่อการเปลี่ยนแปลงเล็กน้อย ในนโยบายของรัฐบาล
at a time when we appear close to success.	ในเวลาที่เราดูใกล้จะประสบความสำเร็จ
[Jean-Marie] As Vietnam began to be more and more chaotic,	เมื่อเวียดนามเริ่มจะวุ่นวายขึ้นเรื่อยๆ
I certainly wondered very much whether we should be there.	ฉันสงสัยมากว่าทำไมเราควรไปที่นั่น
But I never expressed that to him.	แต่ฉันไม่เคยแสดงความคิดนั้นกับเขา
That's one of those conflicts that's just too difficult	นั่นเป็นหนึ่งในข้อขัดแย้ง ซึ่งยากเกินไปที่จะยกขึ้นมาพูด
to bring up, or at least it was for me.	หรืออย่างน้อยที่สุดก็สำหรับฉัน
[Galloway] We were all excited about the arrival	เราทุกคนตื่นเต้นเกี่ยวกับการมาถึง ของกองทหารม้าที่หนึ่ง
of the 1st Cavalry Division, an experimental unit.	เราทุกคนตื่นเต้นเกี่ยวกับการมาถึง ของกองทหารม้าที่หนึ่ง หน่วยทดลอง
They've been trained in air-mobile warfare	พวกเขาได้รับการฝึกในการสู้รบในอากาศ
using these helicopters to the absolute maximum benefit.	โดยใช้เฮลิคอปเตอร์พวกนี้ให้เกิดประโยชน์สูงสุด
They're moving their artillery by helicopter, jumping it,	พวกเขาย้ายปืนใหญ่ โดยเฮลิคอปเตอร์ กระโดดลงมา
leapfrogging troops, chasing the enemy, driving him crazy.	กองทหารที่กระโดดและวิ่งไล่ศัตรู ทำให้เขารู้สึกคลั่ง
This is something new,	นี่เป็นเรื่องใหม่
and it's going to change the way we do war.	และจะเปลี่ยนวิธีที่เราทำสงคราม (โจ กัลโลเวย)์ (นักหนังสือพิมพ์)
[narrator] In September of 1965, the newly created 1st Cavalry Division,	ในเดือนกันยายน ปี 1965 กองทหารม้าที่หนึ่ง ซึ่งเพิ่งสร้างขึ้นใหม่
16,000 men, 1600 vehicles,	ทหาร 16,000 นาย พาหนะ 1,600 คัน
435 helicopters,	เฮลิคอปเตอร์ 435 ลำ
had begun arriving at An Khe, a massive base carved out	เริ่มมาถึงที่อานเข่ ฐานทัพขนาดใหญ่ที่ทำเป็นรูปทุ่งหญ้า
of the grasslands at the edge of the Central Highlands.	ฐานทัพขนาดใหญ่ที่ทำเป็นรูปทุ่งหญ้า ที่ริมที่ราบสูงตอนกลาง
Its heliport would come to be called the "Golf Course."	ลานขึ้นลงของเฮลิคอปเตอร์ของที่นั่น ถูกเรียกว่าสนามกอล์ฟ
As the 1st Cavalry got used to its new surroundings,	เมื่อกองทหารม้าที่หนึ่ง คุ้นเคยกับสภาพแวดล้อมใหม่
thousands of North Vietnamese regulars were slipping south	ทหารเวียดนามเหนือหลายพันนายเข้าไปฝ่ายใต้
into the Highlands along the Ho Chi Minh Trail,	ในที่ราบสูงข้างๆ เส้นทางโฮจิมินห์
joining Viet Cong units already in place.	เพื่อเข้าร่วมหน่วยเวียดกงที่ประจำการอยู่แล้ว (แม่น้ำเอีย ดราง - เปลเม่ เทือกเขาชูปอง)
They established their own base on and around	(แม่น้ำเอีย ดราง - เปลเม่ เทือกเขาชูปอง) พวกเขาสร้างฐานทัพของตัวเองบนความยุ่งเหยิง
a jumble of thickly forested mountains and ravines	พวกเขาสร้างฐานทัพของตัวเองบนความยุ่งเหยิง ของภูเขาและหุบเขาป่าหนาทึบ ทางใต้ของแม่น้ำเอียดรัง
south of the Ia Drang River.	ของภูเขาและหุบเขาป่าหนาทึบ ทางใต้ของแม่น้ำเอียดรัง
On the evening of October 19,	ในตอนเย็นของวันที่ 19 ตุลาคม
communist commandos slipped to within 40 yards	คอมมานโดของคอมมิวนิสต์เข้ามา ภายใน 40 หลาของเส้นรอบวง
of the perimeter wire of the U.S. Special Forces outpost at Plei Me,	คอมมานโดของคอมมิวนิสต์เข้ามา ภายใน 40 หลาของเส้นรอบวง ของด่านหน้าของกองกำลังพิเศษสหรัฐที่เปลเม่
which was defended by a 12-man team of U.S. Green Berets,	ซึ่งป้องกันโดยทีมกรีนเบอเรต์ของสหรัฐ จำนวน 12 นาย
14 A.R.V.N., and some 400 mountain tribesmen.	ทหารเออาร์วีเอ็น 14 นาย และชาวเขา 400 คน
Nine of the 12 Green Berets were hit.	ทหารเก้านายจาก 12 ในทีมกรีนเบอเรต์ถูกยิง
They managed to hold out for two days	พวกเขาสามารถตรึงไว้ได้สองวัน
before 15 more Green Berets and 160 South Vietnamese Rangers	ก่อนที่กรีนเบอเรต์อีก 15 นาย และทหารจู่โจมของเวียดนามใต้อีก 160 นาย
were helicoptered in, commanded by Major Charles Beckwith,	ถูกส่งมาทางเฮลิคอปเตอร์ บัญชาการโดย พันตรีชาลส์ เบ็ควิท
known to his fellow soldiers as Chargin' Charlie.	เพื่อนทหารของเขาเรียกว่า ชาร์ลีจอมจู่โจม
The next day, Joe Galloway managed to talk a helicopter pilot	วันถัดมา โจ กัลโลเวย์ คุยกับนักบินเฮลิคอปเตอร์
into flying him into the besieged camp.	ให้พาเขาบินไปที่ค่ายซึ่งถูกโอบล้อมด้วยศัตรู
[Galloway] That's where I met Major Charles Beckwith.	ผมได้พบกับพันตรีชาลส์ เบ็ควิทที่นั่น
He said, "I need everything in the world.	เขาพูดว่า "ผมต้องการทุกอย่างในโลก
And what has the Army in its wisdom sent me	และกองทัพใช้สติปัญญาส่งอะไรมาให้ผม
but a godforsaken reporter?"	นอกจากผู้สื่อข่าวที่น่าหดหู่
He drug me over and showed me a 30-caliber air-cooled machine gun.	เขามอมยาผมและแสดงให้ผมดู ปืนกลระบายความร้อนด้วยอากาศลำกล้อง 30
He showed me how to load it, how to clear a jam.	เขาแสดงวิธีการโหลดปืนและการเคลียร์ลำกล้อง
[narrator] "You can shoot the little brown men outside the wire,"	"คุณสามารถยิงคนผิวน้ำตาลตัวเล็ก ด้านนอกเส้นลวดได้"
Beckwith told Galloway.	เบ็ควิทบอกกัลโลเวย์
"You may not shoot the little brown men inside the wire. They are mine."	"คุณไม่สามารถยิงคนผิวน้ำตาลตัวเล็ก ด้านในเส้นลวดได้ พวกเขาเป็นคนของผม"
[Galloway] And I'm sitting there thinking,	ผมนั่งคิดอยู่ตรงนั้นว่า
"Ah, I'm a civilian noncombatant."	"ผมเป็นแค่พลเรือนทั่วไป"
I tried that line on Beckwith and he said,	ผมลองพูดแบบนั้นกับเบ็ควิทและเขาพูดว่า
"Ain't no such thing in these mountains, son."	"ไม่มีเรื่องแบบนั้นในภูเขาแถบนี้หรอก เจ้าหนุ่ม"
[narrator] For nearly a week, the North Vietnamese launched assault	เป็นเวลาเกือบสัปดาห์ เวียดนามเหนือมีการโจมตี
after assault on Plei Me.	ครั้งแล้วครั้งเล่าที่เปลเม่
It was only after American bombs and napalm	เพียงหลังจากระเบิดและนาปาล์มของอเมริกา
turned the surrounding terrain into a moonscape	ได้เปลี่ยนภูมิประเทศรอบๆ ให้เป็นพื้นผิวดวงจันทร์
that the enemy withdrew.	ที่ศัตรูถอนตัวไป
[John Laurence] What kind of fighters	เวียดกงที่คุณพบที่นี่เป็นนักสู้ประเภทไหน
are the Viet Cong that you met here?	เวียดกงที่คุณพบที่นี่เป็นนักสู้ประเภทไหน (พันตรีชาลส์ เอ. เบ็ควิท)
I would give anything to have 200 of them under my command.	ผมจะยอมแลกทุกอย่าง ให้ได้พวกเขา 200 นายมาอยู่ใต้บัญชาการ
They're the finest soldiers I've ever seen.	พวกเขาเป็นทหาร ที่ยอดเยี่ยมที่สุดเท่าที่เคยเห็นมา
-The Viet Cong. -That's right.	- เวียดกงเหรอ - ใช่แล้ว
They're dedicated, and they're good soldiers.	พวกเขาทุ่มเทและเป็นทหารที่ดีมาก
They're the best I've ever seen.	พวกเขายอดเยี่ยมที่สุดเท่าที่เคยพบ
[narrator] Despite the losses, his men had suffered at Plei Me,	ทั้งที่พ่ายแพ้ คนของเขาทรมานที่เปลเม่
the North Vietnamese commander, General Chu Huy Man,	ผู้บัญชาการของเวียดนามเหนือ นายพลชู ฮุย มัน
was eager for another confrontation with the Americans.	กระตือรือร้นที่จะเผชิญหน้ากับทหารอเมริกันอีก
He was determined to learn how to fight them.	เขาตั้งใจที่จะเรียนรู้วิธีต่อสู้กับพวกเขา
Reinforcements streaming down the Ho Chi Minh Trail	กองกำลังเสริมเดินทางไปตามเส้นทางโฮจิมินห์
to the Ia Drang Valley	ไปยังหุบเขาเอียดรัง
included a newly minted second lieutenant, Lo Khac Tam,	รวมถึงร้อยตรีที่ได้รับแต่งตั้งใหม่ โล คั๊ก ตัม
who had volunteered to fight in the South.	ผู้ที่อาสาไปต่อสู้ในฝ่ายใต้
I had a girlfriend, but I didn't tell her about it,	(โล ค๊ัก ตัม) (กองทัพเวียดนามเหนือ) ผมไม่ได้บอกเธอเรื่องนี้
because it was a secret mission.	เพราะมันเป็นภารกิจลับ
After we got to the Chu Pong mountains,	หลังจากที่เราไปถึงภูเขาชูปอง
I realized that to be an officer I would have to learn to command.	ผมรู้ว่าในการเป็นเจ้าหน้าที่ ผมจะต้องเรียนรู้ที่จะบัญชาการ
And the best way to learn would be in battle.	และวิธีที่ดีที่สุดในการเรียนรู้จะอยู่ในการต่อสู้
[narrator] On the morning of November 14, 1965,	(หุบเขาเอียดรัง) ในตอนเช้าของวันที่ 14 พฤศจิกายน 1965
1st Cavalry helicopters belonging to the 1st Battalion of the 7th Regiment,	เฮลิคอปเตอร์ทหารม้าที่หนึ่ง ซึ่งเป็นของกองพันที่หนึ่งของกองทหารที่เจ็ด
George Armstrong Custer's old outfit,	หน่วยปฏิบัติการเก่า ของจอร์จ อาร์มสตรอง คัสเตอร์
flew west along the Ia Drang toward the Chu Pong Massif,	บินไปทางตะวันตกข้างเอียดรัง ไปยังเทือกเขาชูปอง
looking for the enemy.	เพื่อมองหาศัตรู
Their commander, Kentucky-born Korean-War veteran	ผู้บัญชาการของพวกเขา ทหารผ่านศึกสงครามเกาหลีที่เกิดในเคนทักกี
Lieutenant Colonel Hal Moore,	พันโทฮัล มัวร์
had been told there was a large enemy base camp	ได้รับแจ้งว่ามีค่ายศัตรูขนาดใหญ่
somewhere on its slopes.	ที่ไหนสักแห่งบนที่ลาด
His orders were to take his understrength outfit,	คำสั่งของเขาคือนำหน่วยปฏิบัติการที่มีกำลังไม่มาก
29 officers and just 411 men, find the enemy and kill him.	เจ้าหน้าที่ 29 นายและเพียง 411 คน ไปค้นหาศัตรูและฆ่าเขา
There were two clearings large enough for Moore to bring in	มีที่โล่งสองแห่งซึ่งใหญ่พอสำหรับมัวร์
eight choppers at once.	ที่จะนำเฮลิคอปเตอร์แปดลำจอดพร้อมกัน
He chose the one closest to the mountain, Landing Zone X-Ray.	เขาเลือกที่โล่งที่ใกล้ที่สุดกับภูเขา โซนลงจอดเอ็กซเรย์ (เทือกเขาชูปอง โซนลงจอดเอ็กซเรย์)
Moore made a point of leading from the front.	มัวร์เป็นผู้นำจากแนวหน้า
He was the first man off the first chopper.	เขาเป็นคนแรกที่ลงจากเฮลิคอปเตอร์ลำแรก
He sent four six-man squads 100 yards in every direction.	เขาส่งหน่วยรบที่มีหกนายสี่กอง ไป 100 หลาในทุกทิศทาง
The Ia Drang Valley was so beautiful, one soldier remembered,	ทหารนายหนึ่งจดจำได้ว่า หุบเขาเอียดรังสวยงามมาก
it reminded him of a national park back home.	มันทำให้เขานึกถึงอุทยานแห่งชาติที่บ้านเกิด
Within minutes, Moore's men captured a deserter.	ภายในไม่กี่นาที คนของมัวร์จับทหารหนีทัพ
Terrified and trembling,	ที่หวาดกลัวและตัวสั่น
he said there were three battalions of soldiers	เขาพูดว่ามีกองพันทหารสามกอง
on the mountain, 1600 men.	ในภูเขา ทหาร 1,600 นาย
They wanted very much to kill Americans, he said,	เขาบอกว่าพวกเขาอยากฆ่าทหารอเมริกันมาก
but so far had been unable to find any.	แต่ถึงตอนนี้ยังไม่สามารถหาได้
Moore quickly set up a command post	มัวร์ตั้งที่บัญชาการขึ้นอย่างรวดเร็ว
behind one of the huge termite mounds that dotted the clearing.	ด้านหลังเนินจอมปลวกขนาดใหญ่ที่อยู่ในที่โล่ง
It would take until mid-afternoon for all of his men to be ferried in.	การส่งทหารทั้งหมดของเขามา คงใช้เวลาจนถึงช่วงกลางของตอนบ่าย
He had no time to waste.	เขาเสียเวลาไม่ได้
"We needed to get off the landing zone	"เราต้องออกจากโซนลงจอดและจัดการพวกเขา
and get at them before they could hit us," Moore remembered.	"เราต้องออกจากโซนลงจอดและจัดการพวกเขา ก่อนที่พวกเขาจะโจมตีเรา" มัวร์จำได้
He sent two companies up the slope toward the hidden enemy.	เขาส่งกองร้อยสองกองไปที่ทางลาด เพื่อไปหาศัตรูที่ซ่อนอยู่
Most of the North Vietnamese, like the Americans,	ทหารเวียดนามส่วนใหญ่ก็เหมือนทหารอเมริกัน
were new to combat.	คือไม่คุ้นเคยกับการต่อสู้
They were ordered to fix bayonets.	พวกเขาถูกสั่งให้ซ่อมดาบปลายปืน
[Lo Khac Tam speaking Vietnamese] It was a modern battle,	สงครามนี้เป็นการต่อสู้สมัยใหม่
but we were told the bayonet	แต่เราถูกบอกว่าดาบปลายปืน
symbolized our fighting spirit,	เป็นสัญลักษณ์จิตวิญญาณแห่งการต่อสู้ของเรา (โล คั๊ก ตัม) (กองทัพเวียดนามเหนือ)
attached to the barrels of our rifles.	ที่ติดกับกระบอกปืนไรเฟิลของเรา
[narrator] Colonel Moore had no way of knowing	ผู้พันมัวร์ไม่มีทางรู้ได้เลยว่า
that instead of 1600 enemy soldiers on the mountain,	แทนที่จะเป็นทหารของศัตรู 1,600 นายบนภูเขา
there were 3,000, seven times his strength.	กลับมีถึง 3,000 นาย ซึ่งเป็นเจ็ดเท่าของกำลังของเขา
Within minutes, the Americans found themselves	ภายในไม่กี่นาที ทหารอเมริกันพบว่าตนเอง
under attack from hundreds of North Vietnamese soldiers.	อยู่ภายใต้การโจมตี จากทหารเวียดนามเหนือหลายพันนาย
In the fighting, an overeager second lieutenant	ในการต่อสู้ ร้อยตรีที่กระตือรือล้นเกินไป
led his platoon of 28 men too far away	นำกลุ่มทหาร 28 นายไปไกลเกินไป จากคนที่เหลือในกองร้อยของเขา
from the rest of his company and was surrounded.	นำกลุ่มทหาร 28 นายไปไกลเกินไป จากคนที่เหลือในกองร้อยของเขา และถูกโอบล้อม
The lieutenant was killed.	ร้อยตรีคนนั้นถูกสังหาร
The sergeant who took his place was shot through the head.	จ่าที่รับหน้าที่แทนเขาถูกยิงทะลุศีรษะ
By late afternoon, only seven of the trapped platoon's men	ภายในบ่ายแก่ๆ มีเพียงทหารเจ็ดนาย ของกลุ่มที่ติดกับ
were still capable of firing back.	ยังคงสามารถยิงกลับไปได้
Moore was now engaged in three simultaneous struggles,	ตอนนี้มัวร์เข้าร่วมในการต่อสู้พร้อมกันทั้งสามทาง
to defend the landing zone, attack the North Vietnamese,	เพื่อป้องกันโซนลงจอด โจมตีเวียดนามเหนือ
and find a way to rescue his trapped patrol.	และหาทางช่วยเหลือหน่วยลาดตระเวนที่ติดกับ
That night, Joe Galloway again managed to talk his way	คืนนั้น โจ กัลโลเวย์สามารถ ขอขึ้นเฮลิคอปเตอร์ได้อีกครั้ง
onto a chopper, taking ammunition and water	คืนนั้น โจ กัลโลเวย์สามารถ ขอขึ้นเฮลิคอปเตอร์ได้อีกครั้ง โดยนำอาวุธปืนและน้ำ ไปยังทหารอเมริกันที่ถูกศัตรูล้อม
to the besieged Americans.	โดยนำอาวุธปืนและน้ำ ไปยังทหารอเมริกันที่ถูกศัตรูล้อม
As the helicopter approached the battlefield,	เมื่อเฮลิคอปเตอร์ไปถึงสนามรบ
Galloway was sitting on a crate of grenades,	กัลโลเวย์นั่งอยู่ที่ลังระเบิดมือ
peering out into the darkness.	มองออกไปในความมืด
[Galloway] And I could see these little pin pricks of light	และผมเห็นจุดแสงเล็กๆ พวกนี้
coming down the mountain.	มาจากภูเขา
This was the enemy approaching for the next day's attacks.	นี่เป็นการเดินทางของศัตรู เพื่อการโจมตีในวันถัดไป
We flew in there.	เราบินไปที่นั่น
As they pulled on out, it was dead dark.	ตอนที่พวกเขาออกไป มันมืดมาก
And we're lying there waiting for someone to come tell us what to do.	และพวกเขาหมอบอยู่ที่นั่น รอให้มีคนมาบอกเราว่าต้องทำอะไร
And the next morning, all of a sudden the bottom fell out.	และเช้าวันถัดมา ทันใดนั้นก็เกิดเรื่องร้ายแรงขึ้น
There was an explosion of fire.	มีการยิงกันปะทุขึ้นมา
The noise is horrendous, unimaginable.	เสียงดังกึกก้องเกินจินตนาการ
And in the middle of all of this, you know,	และท่ามกลางเรื่องพวกนี้ทั้งหมด
I just flattened out on the ground	ผมได้แต่หมอบราบอยู่บนพื้น
because all that was being fired seemed to be about two,	เพราะทุกอย่างที่กำลังถูกยิงดูเหมือนว่า
two-and-a-half feet off the ground.	จะอยู่ห่างจากพื้นประมาณสองฟุตครึ่ง
[narrator] Hundreds of enemy soldiers hurled themselves at the Americans.	ทหารของศัตรูหลายร้อยนายพุ่งไปที่ทหารอเมริกัน
They wore webbed helmets camouflaged with grass,	พวกเขาใส่หมวกที่มีสายรัด อำพรางด้วยหญ้า
and as they came, blowing whistles, screaming,	เมื่อพวกเขามาโดยเป่านกหวีด กู่ร้อง
they looked like little trees, one American remembered.	พวกเขาดูเหมือนต้นไม้เล็กๆ ทหารอเมริกันนายหนึ่งจำได้
They were trying to overrun us.	พวกเขาพยายามที่จะบุกรุกเรา
And they came close.	และพวกเขาเข้ามาใกล้
They came close.	พวกเขาเข้ามาใกล้ๆ
But we had two things going for us.	แต่เรามีสองอย่างที่เกิดขึ้นเพื่อเรา
We had a great commander and great soldiers.	เรามีผู้บัญชาการและทหารที่ยอดเยี่ยม
And we had air and artillery support out the yin-yang.	และเรามีกองสนับสนุนทางอากาศ กับปืนใหญ่จำนวนมาก
We had it, and they didn't.	เรามีของ พวกเขาไม่มี
[narrator] But using that air and artillery support could be dangerous.	แต่การใช้การสนับสนุนทางอากาศ และปืนใหญ่อาจเป็นอันตราย
Each of Moore's units carefully marked its position with smoke	แต่ละหน่วยของมัวร์ ทำเครื่องหมายตำแหน่งด้วยควันอย่างระวัง
to keep from being mistaken for the enemy	เพื่อป้องกันไม่ให้เข้าใจผิดว่าเป็นศัตรู
by American airmen overhead.	โดยนักบินอเมริกันที่อยู่ด้านบน
We had to get close.	เราต้องเข้าไปใกล้ๆ
If we didn't,	ถ้าเราไม่ไป
we would be killed right away.	เราจะถูกฆ่าทันที
[narrator] Some 18,000 artillery shells would be called in	กระสุนปืนใหญ่ 18,000 นัดถูกนำมาใช้
over the course of the battle,	ในเส้นทางของการต่อสู้
some of them landing just 25 yards from Moore's own men.	พวกเขาบางส่วนลงพื้น ห่างเพียง 25 หลาจากคนของมัวร์
Helicopter gunships fired 3,000 rockets into the enemy.	เฮลิคอปเตอร์ติดอาวุธ ยิงจรวด 3,000 ลูกใส่ศัตรู
The forward air controller	ผู้ควบคุมการสู้รบส่วนหน้า
called for every available aircraft in South Vietnam	เรียกเครื่องบินที่ว่างทุกลำในเวียดนามใต้
to come and help.	ให้มาช่วย
Warplanes, including B-52 long-range strategic bombers,	เครื่องบินรบ รวมถึงเครื่องบินทิ้งระเบิด เชิงกลยุทธ์ระยะไกล บี-52
were stacked at 1,000-foot intervals above the battlefield,	เรียงซ้อนกันที่ระยะห่าง 1,000 ฟุต เหนือสนามรบ
from 7,000 to 35,000 feet,	จาก 7,000 ถึง 35,000 ฟุต
impatiently awaiting targets to strafe, or bomb, or burn.	รอเป้าหมายอย่างไม่อดทน เพื่อยิง วางระเบิด หรือเผา
"By God," Moore said, "they sent us over here to kill communists	"โดยพระเจ้า" มัวร์กล่าว "พวกเขาส่งเรามาที่นี่เพื่อฆ่าคอมมิวนิสต์
and that's what we're doing."	และนั่นเป็นสิ่งที่เรากำลังทำอยู่"
I looked up,	ผมมองขึ้นไป
and there were two jets aiming directly at our command post.	มีเครื่องบินเจ็ตสองลำ มุ่งตรงมาที่บัญชาการของเรา
He's dropped two cans of napalm and it's coming toward us,	เขาทิ้งระเบิดนาปาล์มสองลูก และมันตรงมาหาเรา
loblolly, end over end.	ต้นสน พลิกกลับด้าน
And these kids, two or three of 'em, plus a sergeant,	และเด็กพวกนี้สองหรือสามคน รวมจ่าอีกนาย
had dug a hole or two over on the edge.	ได้ขุมหลุมสองหลุมไว้ที่ขอบ
And I looked as the thing exploded...	และผมดูในขณะที่สิ่งต่างๆ ระเบิด
And two of them were dancing in that fire.	และพวกมันสองคนก็เต้นในเปลวไฟนั้น
And there's a rush, a roar,	และมีการเร่งรีบ การกู่ร้อง
from the air that's being consumed	จากอากาศที่กำลังถูกใช้และดึงไป
and drawn in as this, this hell come to earth	จากอากาศที่กำลังถูกใช้และดึงไป ตอนที่นรกนี้มายังโลกที่กำลังไหม้อยู่
is burning there.	ตอนที่นรกนี้มายังโลกที่กำลังไหม้อยู่
And as that dies back a little, then you can hear the screams.	และเมื่อสิ่งนั้นตายไปเล็กน้อย จากนั้นคุณถึงสามารถได้ยินเสียงกรีดร้อง
And someone yells, "Get this man's feet."	และมีคนตะโกน "เก็บเท้าของผู้ชายคนนี้"
And I reach down and the boots crumble,	ผมก้มลงไปและรองเท้าบูทขาดวิ่น
and the flesh is cooked off of his ankles.	เนื้อตรงข้อเท้าของเขาถูกย่างสุก
And I feel those bones in the palms of my hands.	และผมรู้สึกถึงกระดูกในอุ้งมือของผม
I can feel it now.	ตอนนี้ผมก็รู้สึกถึงมันได้
He died two days later.	เขาตายในอีกสองวันต่อมา
A kid named Jim Nakayama out of Rigby, Idaho.	เด็กหนุ่มชื่อ จิม นากายามะมาจากริกบี้ ไอดาโฮ
[narrator] By ten o'clock that morning,	ตอนสิบโมงในเช้าวันนั้น
American airpower had beaten back the enemy assault.	กองกำลังทางอากาศของอเมริกา ตอบโต้การโจมตีของศัตรู
The survivors from the trapped platoon were rescued that afternoon.	ผู้มีชีวิตรอดจากกองร้อยที่ติดกับ ถูกช่วยเหลือในบ่ายนั้น
They had been pinned to the ground and under fire	พวกเขาถูกตรึงกับพื้นและถูกยิงโจมตีมานาน
for so long that they had to be coaxed	พวกเขาถูกตรึงกับพื้นและถูกยิงโจมตีมานาน จนพวกเขาต้องถูกโน้มน้าวให้ยืนขึ้นอีกครั้ง
into getting to their feet again.	จนพวกเขาต้องถูกโน้มน้าวให้ยืนขึ้นอีกครั้ง
On the morning of the next day,	เช้าในวันถัดมา
enemy soldiers hurled themselves against the same sector	ทหารของศัตรูโจมตีใส่กลุ่มเดิม
of Moore's line four more times	ที่เป็นแนวหน้าของมัวร์อีกสี่ครั้ง
and were obliterated by artillery and machine gun fire.	และถูกกำจัดด้วยการยิงปืนใหญ่และปืนกล
The surviving North Vietnamese and Viet Cong	เวียดนามเหนือและเวียดกงที่รอดชีวิต
withdrew into the forest,	ถอนตัวเข้าป่า
leaving behind a ghastly ring of their dead	ทิ้งกลุ่มผู้เสียชีวิตที่น่าสยดสยอง ของพวกเขาไว้เบื้องหลัง
surrounding the landing zone,	ซึ่งอยู่รอบๆ โซนลงจอด
634 corpses, shot, blasted, blackened by fire.	ร่าง 634 ศพถูกยิง ระเบิด ถูกไฟเผาจนไหม้
[Khac Tam speaking Vietnamese] When I saw my soldiers dying,	เมื่อผมเห็นทหารฝ่ายตัวเองตาย
I felt deep sorrow for them.	ผมโศกเศร้าให้กับพวกเขามาก
I did't cry,	ผมไม่ได้ร้องไห้
I tried to hold back tears.	ผมพยายามกลั้นน้ำตาไว้
We were shocked psychologically.	เรารู้สึกสะเทือนจิตใจ
[narrator] After three days and two nights of combat,	หลังจากสามวันและสองคืนแห่งการต่อสู้
helicopters began lifting out the American survivors	เฮลิคอปเตอร์เริ่มมารับทหารอเมริกันที่มีชีวิตรอด
and gathering up the dead.	และรวบรวมผู้เสียชีวิต
[soldier] When you look at them,	เมื่อคุณมองพวกเขา
it doesn't even resemble a human body.	มันดูไม่เหมือนร่างของมนุษย์ด้วยซ้ำ
It just, it looks just like a mannequin.	มันดูราวกับหุ่น
You look at them and say, "That couldn't happen to me."	คุณมองไปที่พวกเขาและพูดได้ว่า "เรื่องนั้นคงไม่เกิดกับฉัน"
[Neil Sheehan] I saw them fight at Ia Drang.	ผมเห็นพวกเขาต่อสู้ที่เอียดรัง
It always galls me when I read or hear	ผมรู้สึกโกรธทุกครั้งเวลาที่ผมอ่านหรือได้ยิน... (นีล ชีแฮน) (นักหนังสือพิมพ์)
about the World War II generation	(นีล ชีแฮน) (นักหนังสือพิมพ์) เรื่องคนรุ่นสงครามโลกครั้งที่สอง เป็นรุ่นที่ยอดเยี่ยมที่สุด
as the greatest generation.	เรื่องคนรุ่นสงครามโลกครั้งที่สอง เป็นรุ่นที่ยอดเยี่ยมที่สุด
These kids were just as gallant and as courageous	เด็กพวกนี้กล้าหาญและองอาจ
as anybody who fought in World War II.	เท่ากับบุคคลที่ต่อสู้ในสงครามโลกครั้งที่สอง
[narrator] Seventy-nine of Hal Moore's men lost their lives	ทหารของมัวร์เสียชีวิต 79 นาย
at Landing Zone X-Ray in the Ia Drang Valley	ที่โซนลงจอดเอ็กซเรย์ในหุบเขาเอียดรัง
and another 121 were wounded.	และอีก 121 นายได้รับบาดเจ็บ
Please convey to the American people	โปรดแสดงให้ประชาชนชาวอเมริกันเห็นว่า (พันโทฮัล มัวร์)
what a tremendous fighting man we have here.	เรามีนักรบที่ยิ่งใหญ่เพียงใดอยู่ตรงนี้
He's courageous, he's aggressive, and he's kind.	เขาองอาจ ห้าวหาญ และอ่อนโยน
And he'll go where you tell him to go.	เขาจะไปในที่ที่คุณบอกให้เขาไป
And he's got self-discipline.	เขามีระเบียบวินัยในตัวเอง
And he's got good unit discipline.	และมีวินัยในหน่วยที่ดี
He's just an outstanding man.	เขาเป็นชายที่ยอดเยี่ยมมาก
And...	และ...
Having commanded this battalion for 18 months...	การได้บัญชาการกองพันนี้เป็นเวลา 18 เดือน
You must excuse my emotion here,	ผมขอโทษที่แสดงอารมณ์ตรงนี้
but when I see some of these men go out the way they have...	แต่เมื่อผมเห็นคนเหล่านี้บางส่วน ออกไปในทางที่พวกเขา...
I haven't...	ผมไม่ได้...
I can't tell you how highly I feel for them.	ผมไม่สามารถบอกคุณได้ว่า ผมยกย่องพวกเขามากเพียงใด
They're tremendous.	พวกเขายอดเยี่ยมมาก
[narrator] Hal Moore refused to leave	ฮัล มัวร์ปฏิเสธที่จะไป
until every single man in his command had been accounted for.	จนกว่าทุกคนภายใต้บัญชาการของเขา จะได้รับการช่วยเหลือ
He had been the first of his men to step onto Landing Zone X-Ray,	เขาเป็นคนแรกในกองทหารของเขา ที่ก้าวสู่โซนลงจอดเอ็กซเรย์
and he made sure he was the last to leave it.	และเขายืนยันจะเป็นคนสุดท้ายที่จะออกมา
[Khac Tam speaking Vietnamese] The war we fought was so horribly brutal	สงครามที่เราต่อสู้โหดร้ายมาก
that I don't have the words to describe it.	จนผมไม่มีคำพูดใดที่จะอธิบายได้
I worry, how can we ever explain	ผมกังวลว่าเราจะอธิบายอย่างไร
to the younger generation	ให้กับคนรุ่นหลัง
the price their parents and grandparents paid?	ถึงสิ่งที่พ่อแม่และปู่ย่าของพวกเขาต้องแลกมา
[narrator] The North Vietnamese suffered terrible losses in the Ia Drang Valley	เวียดนามเหนือพบกับความพ่ายแพ้ อย่างหนักในหุบเขาเอียดรัง
and many of the survivors were traumatized.	และผู้รอดชีวิตหลายรายได้รับความบอบช้ำ
"The units were enveloped in an atmosphere of gloom,"	"หน่วยต่างๆ ถูกหุุ้ม ในบรรยากาศของความโศกเศร้า"
a North Vietnamese colonel remembered.	ผู้พันของเวียดนามเหนือจำได้
Some men would not leave their rope hammocks.	บางคนไม่ยอมทิ้งเปลญวนของพวกเขา
Some refused to wash.	บางคนไม่ยอมซัก
One soldier wrote a poem expressive of their plight,	ทหารนายหนึ่งเขียนกลอน ที่แสดงถึงสถานการณ์เลวร้าย
"The crab lies still on the chopping block	"ปูนอนนิ่งบนเขียง
Never knowing when the knife will fall."	ไม่รู้ว่ามีดจะสับลงมาเมื่อไหร่"
[Galloway] In the Ia Drang we killed ten of them for every one of us.	ในเอียดรัง เราฆ่าพวกเขาสิบคนต่อเราหนึ่งคน
That's a ten-to-one kill ratio is how the military puts that.	เป็นอัตราส่วนการฆ่าสิบต่อหนึ่ง ที่ทหารคำนวณออกมา
But the enemy, he was fully prepared to pay that price	แต่ศัตรู พวกเขาเตรียมพร้อมเต็มที่ เพื่อที่จะรับผลของสิ่งนั้นหรือยิ่งกว่า
and more for the value of the lessons he learned.	แต่ศัตรู พวกเขาเตรียมพร้อมเต็มที่ เพื่อที่จะรับผลของสิ่งนั้นหรือยิ่งกว่า สำหรับมูลค่าของบทเรียนที่ได้เรียนรู้
To fight the Americans,	ในการต่อสู้กับทหารอเมริกัน
we had to get close,	เราต้องเข้าไปใกล้ๆ
grab them by the belt.	ดึงเข็มขัดของพวกเขา
If we didn't,	ถ้าเราไม่ทำ
we couldn't fight them,	เราจะสู้พวกเขาไม่ได้
and we would be killed.	และเราจะถูกฆ่า
[Galloway] Grab 'em by the belt buckle.	จับหัวเข็มขัดของพวกเขา
That means you've got to get so close,	หมายถึงคุณต้องเข้าไปใกล้มาก
they can't use the artillery and the aerial bombardments on you	จนพวกเขาไม่สามารถใช้ปืนใหญ่ หรือการระดมยิงทางอากาศใส่คุณ
for fear of killing their own.	เพราะกลัวว่าจะฆ่าพวกเดียวกัน
Get in so close that it's man-on-man.	เข้าไปใกล้มากจนเป็นการสู้ตัวต่อตัว
And then everything is even.	แล้วทุกอย่างก็จะเสมอกัน
The Vietnamese suffered hundreds of dead	ทหารเวียดนามต้องเสียชีวิตหลายพันนาย
attacking Hal Moore's battalion at LZ X-Ray.	จากการโจมตีกองพันของฮัล มัวร์ ที่โซนลงจอดเอ็กซเรย์
But then they ambushed another battalion a couple of days later	แต่แล้วพวกเขาซุ่มโจมตีอีกกองร้อย ในอีกสองวันต่อมาและทำลายจนสิ้นซาก
and wiped it out.	แต่แล้วพวกเขาซุ่มโจมตีอีกกองร้อย ในอีกสองวันต่อมาและทำลายจนสิ้นซาก (โซนลงจอดอัลบานี โซนลงจอดเอ็กซ์เรย์)
[narrator] In the fighting near Landing Zone Albany,	ในการต่อสู้ใกล้โซนลงจอดอัลบานี
the enemy had gotten too close for artillery to be called in.	ศัตรูเข้ามาใกล้เกินไปที่จะใช้ปืนใหญ่
Out of some 425 Americans involved, 155 were killed.	ทหารอเมริกัน 155 จาก 425 นายที่เข้าร่วมถูกฆ่า
124 more were wounded.	อีก 124 นายได้รับบาดเจ็บ
Both sides claimed victory in the Ia Drang Valley.	ทั้งสองฝ่ายอ้างชัยชนะในหุบเขาเอียดรัง (พลจัตวาริชาร์ด เค โนวส์) (ผู้ช่วยผู้บัญชาการทหารม้าที่ 1)
The Americans talked up the number of enemy dead	ทหารอเมริกันพูดถึงจำนวนศัตรูที่เสียชีวิต
at Landing Zone X-Ray.	ที่โซนลงจอดเอ็กซ์เรย์
The ratio of losses to your kill...	อัตราส่วนของความพ่ายแพ้ต่อการฆ่าของคุณ
[narrator] The North Vietnamese took their lessons from Landing Zone Albany.	เวียดนามเหนือได้รับบทเรียน จากโซนลงจอดอัลบานี
[William Westmoreland] I don't anticipate	ผมไม่ได้คาดว่า
that this conflict will end any time soon,	ความขัดแย้งนี้จะจบลงในเร็วๆ นี้
and we could find that we have more difficult days ahead.	(นายพลวิลเลียม เวสต์มอร์แลนด์) และเราพบว่า เราจะมีวันที่ลำบากกว่าอยู่เบื้องหน้า
Certainly we must be prepared for this.	แน่นอนว่าเราต้องเตรียมพร้อมสำหรับเรื่องนี้
[Ehrhart] In the fall of my senior year, November 1965,	(จีเอขยี้กองทหารประจำการของฮานอย การต่อสู้ราคาแพงที่สุดของชาวอเมริกัน) ในฤดูใบไม้ร่วงของปีสุดท้ายของผม เดือนพฤศจิกายน 1965
was that huge battle at the Ia Drang Valley,	การต่อสู้ครั้งใหญ่ที่หุบเขาเอียดรัง
which was the first time there was actually confirmed	ซึ่งเป็นครั้งแรกที่มีการยืนยันอย่างจริงจังว่า
North Vietnamese regular soldiers as opposed to Viet Cong.	ทหารประจำการของเวียดนามเหนือ แยกออกจากเวียดกง
And of course my way of interpreting that was,	แน่นอนว่าวิธีที่ผมแปลความหมายเรื่องนั้นคือ... (บิล แอร์ฮาร์ท) (เพอร์กาซี เพนซิลเวเนีย)
"There it is, that's the proof.	"นั่นไงล่ะ นั่นคือหลักฐาน
The North Vietnamese are the aggressors here."	เวียดนามเหนือเป็นพวกก้าวร้าว"
And that's when I began thinking in terms of,	นั่นเป็นตอนที่ผมเริ่มคิดในแง่ที่ว่า
maybe I don't want to go to college right away.	บางทีผมอาจไม่อยากไปมหาวิทยาลัยทันที
Maybe I'll join the Marines.	ผมจะไปร่วมกับนาวิกโยธิน
And it was always the Marines. I never...	และต้องเป็นนาวิกโยธิน ผมไม่เคย...
There was no question.	ไม่มีข้อกังขาเลย
The Marine Corps is full of little guys like me	นาวิกโยธินเต็มไปด้วยคนตัวเล็กแบบผม
with chips on our shoulder.	ที่แบกความโกรธเกลียดไว้
[narrator] The battles in the Ia Drang Valley may have been declared	การต่อสู้ในหุบเขาเอียดรัง อาจได้รับการประกาศเป็นชัยชนะของอเมริกา
American victories, but privately, General Westmoreland	การต่อสู้ในหุบเขาเอียดรัง อาจได้รับการประกาศเป็นชัยชนะของอเมริกา แต่โดยส่วนตัวแล้ว นายพลเวสต์มอร์แลนด์
and the Johnson administration were worried.	และฝ่ายบริหารของจอห์นสันรู้สึกกังวล
In spite of the Americans' new airborne mobility,	ทั้งที่มีความเคลื่อนไหว ของกองพลส่งทางอากาศอเมริกัน
the enemy had been able to choose	ศัตรูก็สามารถเลือก
the place and time of battle.	สถานที่และเวลาในการต่อสู้ได้
The intelligence on which basic decisions had been made	ข่าวกรองซึ่งใช้ในการตัดสินใจขั้นพื้นฐาน
in Washington had been uniformly bad.	ในวอชิงตันก็ไม่ดีพอๆ กัน
There were now believed to be 12 Viet Cong regiments	ตอนนี้เชื่อว่ามีกองทหารเวียดกง 12 กอง
in South Vietnam, not just five.	ในเวียดนามใต้ ไม่ใช่แค่ห้ากอง
Nine North Vietnamese regiments, not three.	กองทหารเวียดนามเหนือเก้ากอง ไม่ใช่สาม
Despite months of bombing,	ทั้งที่มีการทิ้งระเบิดหลายเดือน
three times as many North Vietnamese regulars	ทหารประจำการของเวียดนามสามเท่า
were now slipping south of the demilitarized zone	กำลังผ่านเข้าทางใต้ของเขตปลอดทหาร
as originally believed.	ตามที่เชื่อกันแต่แรก
Hanoi seemed to be escalating, too.	ฮานอยดูจะเพิ่มมากขึ้นเหมือนกัน
And American casualties were climbing.	ผู้ประสบภัยชาวอเมริกันก็กำลังเพิ่มขึ้น
When Senator Fritz Hollings visited Saigon shortly after the Ia Drang battles,	เมื่อวุฒิสมาชิกฟริตซ์ ฮอลลิงส์ไปที่ไซ่ง่อน ไม่นานหลังจากการต่อสู้ที่เอียดรัง
General Westmoreland told him, "We're killing these people	นายพลเวสต์มอร์แลนด์บอกเขาว่า "เราฆ่าคนพวกนี้ด้วยอัตราสิบต่อหนึ่ง"
at a rate of ten to one."	"เราฆ่าคนพวกนี้ด้วยอัตราสิบต่อหนึ่ง"
Hollings warned him,	ฮอลลิงส์เตือนเขาว่า
"Westy, the American people don't care about the ten.	"เวสตี้ ประชาชนชาวอเมริกัน ไม่สนใจสิบคนนั้นหรอก
They care about the one."	พวกเขาใส่ใจกับหนึ่งคนนั้น"
Westmoreland, who had said he could win the war	เวสต์มอร์แลนด์ซึ่งบอกว่า เขาสามารถชนะสงครามได้ในสามปี
in three years, now sent an urgent cable to Washington	เวสต์มอร์แลนด์ซึ่งบอกว่า เขาสามารถชนะสงครามได้ในสามปี ตอนนี้ส่งโทรเลขด่วนไปวอชิงตัน เพื่อขอทหารเพิ่มอีก 200,000 นาย
asking for 200,000 more troops.	ตอนนี้ส่งโทรเลขด่วนไปวอชิงตัน เพื่อขอทหารเพิ่มอีก 200,000 นาย
"The message came as a shattering blow," Robert McNamara remembered.	"ข้อความนั้นเป็นเหมือนลมแห่งความสิ้นหวัง" โรเบิร์ต แมคนามาร่าจำได้
Once again, he offered Johnson two options,	เขาเสนอทางเลือกสองทางให้จอห์นสันอีกครั้ง
try to negotiate a compromise with Hanoi,	พยายามเจรจาประนีประนอมกับฮานอย
or accede to Westmoreland's request for more men,	หรือเห็นด้วยกับคำขอ ของเวสต์มอร์แลนด์ที่ขอทหารเพิ่ม
though the chances of victory, the secretary of defense said,	รัฐมนตรีกระทรวงกลาโหมบอกว่า แม้โอกาสที่จะชนะ
might be no better than one in three.	อาจไม่ดีไปกว่าหนึ่งในสาม
[Galloway] And then they all sat down	จากนั้นพวกเขาทุกคนนั่งลง
and voted for option two.	และโหวตทางเลือกที่สอง
[Karl Marlantes] My bitterness about the political powers at the time	ความขมขื่นของผม เกี่ยวกับอำนาจทางการเมืองในตอนนั้น
was, first of all, the lying.	อย่างแรกเลยก็คือการโกหก (คาร์ล มาร์ลันเตส) (นาวิกโยธิน)
I mean, I can understand a policy error	คือผมสามารถเข้าใจความผิดพลาดทางนโยบาย
that is incredibly, incredibly painful	ที่มันเจ็บปวดมากอย่างไม่น่าเชื่อ
and kills a lot of people out of a mistake	และคร่าชีวิตผู้คนมากมายเพราะความผิดพลาด
if they made that with noble hearts.	หากพวกเขาทำสิ่งนั้นด้วยใจที่มีคุณธรรม
That was, you know, when Eisenhower and Kennedy	นั่นเป็นตอนที่ไอเซนฮาวร์และเคนเนดี้
were trying to figure things out.	พยายามที่จะแก้ไขปัญหาต่างๆ
And you read that, you know, McNamara knew by '65,	และคุณได้อ่านว่าแมคนามาร่ารู้ภายในปี 1965
it was just three years before I was there	เพียงสามปีก่อนที่ผมจะไปที่นั่น
that the war was unwinnable.	เขารู้ว่าสงครามนั้นไม่สามารถชนะได้
That's what makes me mad.	เรื่องนั้นทำให้ผมโกรธ
Making a mistake, people can do that.	คนเราอาจทำผิดพลาดได้
But covering up mistakes,	แต่การปกปิดความผิดพลาด
then you're killing people for your own ego.	แล้วคุณยังฆ่าผู้คนเพื่ออีโก้ของตัวเอง
And that makes me mad.	เรื่องนั้นทำให้ผมโมโห
[narrator] Tens of thousands of American troops continued to prepare to deploy to Vietnam	ทหารอเมริกันหลายหมื่นนาย ยังคงเตรียมที่จะเคลื่อนกำลังไปเวียดนาม
from all over the country,	จากทั่วประเทศ
and General Westmoreland and his commanders	นายพลเวสต์มอร์แลนด์และผู้บัญชาการของเขา
drew up plans for major offensives in the new year of 1966.	ใช้แผนการโจมตีสำคัญในปีใหม่ในปี 1966
Meanwhile, hoping the Soviets might help bring Hanoi	ในเวลาเดียวกันก็หวังว่าโซเวียต อาจช่วยนำฮานอย
to the bargaining table, McNamara urged the president	มายังโต๊ะเจรจา แมคนามาร่าขอให้ประธานาธิบดี
to declare a halt to the bombing of North Vietnam.	ประกาศการยุติชั่วคราว ต่อการทิ้งระเบิดในเวียดนามเหนือ
Over the objections of the military,	แม้จะมีการคัดค้านของกองทัพ
who worried it would give the enemy time to rebuild its defenses,	ที่กังวลว่าจะทำให้ศัตรูมีเวลา ในการสร้างการป้องกันขึ้นมาใหม่
Johnson agreed to stop the bombing on Christmas Eve.	จอห์นสันตกลงที่จะหยุดทิ้งระเบิด ในวันคริสต์มาสต์อีฟ
If it achieved nothing else, he said,	(ปฏิบัติการดาวคริสต์มาสต์) เขาบอกว่า ถ้ามันไม่บรรลุผลอย่างอื่น
it would show the American people	ก็จะแสดงให้ประชาชนชาวอเมริกันเห็นว่า
that before he committed more of their sons to battle,	ก่อนที่เขาจะให้ลูกหลานของพวกเขาเข้าร่วมต่อสู้
"We have gone the last mile."	"เราไปถึงขั้นตอนสุดท้ายแล้ว"
[Jean-Marie] Well, Christmas always meant a great deal in our family.	(สุขสันต์วันคริสต์มาสต์ แด่ทหารในเวียดนาม จากโบสถ์คริสต์แห่งแรก) คริสต์มาสต์มีความหมายอย่างมาก ในครอบครัวของเรา
We sent packages to Denton, of course.	แน่นอนว่าเราส่งของไปให้เดนตัน
Then a neighbor mentioned to me	แล้วเพื่อนบ้านก็บอกฉันว่า
that she heard a local television station was offering	เธอได้ยินสถานีโทรทัศน์ในท้องถิ่นกำลังเสนอ
free tapes to be made to send to a soldier overseas.	ที่จะทำเทปฟรีเพื่อส่งให้ทหารที่อยู่ต่างประเทศ
We dressed up for the cameras.	เราจึงแต่งตัวเพื่อไปออกหน้ากล้อง
The idea was that we would each just say something	ไอเดียคือเราแต่ละคนจะพูดอะไรบางอย่าง
about what we were doing and wish him well.	เกี่ยวกับสิ่งที่เราทำอยู่และอวยพรเขา
It was a horrible day for me.	เป็นวันที่แย่สำหรับฉัน
It made it so real that he was far away.	มันทำให้รู้สึกว่าเป็นเรื่องจริงที่เขาอยู่ไกลมาก
Well, Mogie, here we are.	โมกี้ เราอยู่นี่แล้ว
It's... Let's see, what day is today?	เอาล่ะ วันนี้วันอะไร
-Here it is, Saturday... -[chuckles]	นั่นแหละ วันเสาร์
-November 13. -November 13,	- วันที่ 13 พฤศจิกายน - วันที่ 13 พฤศจิกายน
and station WTEN has given us a chance to talk to you.	และสถานีดับเบิ้ลยูทีอีเอ็น ให้โอกาสเราได้คุยกับลูก
We all wish you a Merry Christmas, to start out with.	เราขอเริ่มด้วยการอวยพร สุขสันต์วันคริสต์มาสต์กับลูก
Rand, what do you got to say to Mogie?	แรนด์ ลูกมีอะไรจะคุยกับโมกี้ไหม
Merry Christmas.	สุขสันต์วันคริสต์มาสต์
Merry Christmas.	สุขสันต์วันคริสต์มาสต์
Merry Christmas, darling.	สุขสันต์วันคริสต์มาสต์ลูกรัก
We sent your packages	เราส่งของไปให้ลูก
and there's one that's waiting for you at home.	และมีอย่างหนึ่งที่รอลูกอยู่ที่บ้าน
It's a record of fife and drum music that we got for you at Williamsburg.	ของนั้นคือแผ่นเสียงเพลงขลุ่ยและกลอง ที่เราซื้อให้ลูกที่วิลเลียมส์เบิร์ก
Candy?	แคนดี้จ๊ะ
My teacher isn't very nice, and she always is crabby,	ครูของหนูไม่ค่อยใจดีเท่าไหร่ และเธออารมณ์เสียอยู่เสมอ
and I don't like school at all.	หนูไม่ชอบโรงเรียนเลย
-Now I'm a brownie. -[others chuckling]	ตอนนี้หนูเป็นเนตรนารีระดับสอง
Merry Christmas.	สุขสันต์วันคริสต์มาสต์
Happy Christmas, Mogie.	สุขสันต์วันคริสต์มาสต์ โมกี้
I think I'm getting new skis for Christmas.	ฉันคิดว่าจะซื้อสกีคู่ใหม่สำหรับวันคริสต์มาสต์
So when you get home, we can get together sometime.	ดังนั้นตอนเธอกลับบ้านมา เราจะได้ไปเล่นด้วยกันนะ
We do all wish you a very Merry Christmas,	เราทุกคนอวยพรให้ลูก มีความสุขมากๆ ในวันคริสต์มาสต์นะ
and we'll be thinking of you on Christmas Day.	และเราจะคิดถึงลูกในวันคริต์มาสต์
[Jean-Marie] We miss you, sweetheart.	เราคิดถึงลูกนะ ลูกรัก